a	art.一(个)；每一(个)
abandon	vt.丢弃；放弃，抛弃
ability	n.能力；能耐，本领
able	a.有能力的；出色的
abnormal	a.不正常的；变态的
aboard	ad.在船(车)上；上船
about	prep.关于；在…周围
above	prep.在…上面；高于
abroad	ad.(在)国外；到处
absence	n.缺席，不在场；缺乏
absent	a.不在场的；缺乏的
absolute	a.绝对的；纯粹的
absolutely	ad.完全地；绝对地
absorb	vt.吸收；使专心
abstract	a.抽象的
abundant	a.丰富的；大量的
abuse	vt.滥用；虐待
academic	a.学院的；学术的
academy	n.私立中学；专科院校
accelerate	vt.(使)加快；促进
acceleration	n.加速；加速度
accent	n.口音，腔调；重音
accept	vt.vi.接受；同意
acceptable	a.可接受的，合意的
acceptance	n.接受，验收；承认
access	n.接近；通道，入口
accessory	n.同谋，从犯；附件
accident	n.意外的；事故
accidental	a.偶然的；非本质的
accommodate	vt.容纳；供应，供给
accommodation	n.招待设备；预定铺位
accompany	vt.陪伴，陪同；伴随
accomplish	vt.达到(目的)；完成
accord	vt.使一致；给予
accordance	n.一致；和谐；授予
accordingly	ad.因此，所以；照着
account	n.记述；解释；帐目
accumulate	vt.积累
accuracy	n.准确(性)；准确度
accurate	a.准确的，正确无误的
accuse	vt.指责；归咎于
accustom	vt.使习惯
accustomed	a.惯常的；习惯的
ache	vi.痛；想念
achieve	vt.完成，实现；达到
achievement	n.完成；成就，成绩
acid	n.酸；酸的，酸性的
acquaintance	n.认识；了解；熟人
acquire	vt.取得；获得；学到
acre	n.英亩(=6.07亩)
across	prep.横过；在…对面
act	vi.行动；见效
action	n.行动；作用；功能
active	a.活跃的；积极的
activity	n.活动；活力；行动
actor	n.男演员；演剧的人
actress	n.女演员
actual	a.实际的；现行的
actually	ad.实际上；竟然
acute	a.尖的，锐的；敏锐的
ad	n.广告
adapt	vt.使适应；改编
add	vt.添加，附加，掺加
addition	n.加，加法；附加物
additional	a.附加的，追加的
address	n.地址；演说；谈吐
adequate	a.足够的；可以胜任的
adjective	n.形容词
adjust	vt.调整，调节；校正
administration	n.管理；管理部门
admire	vt.钦佩，羡慕，赞赏
admission	n.允许进入；承认
admit	vt.承认；准许…进入
adopt	vt.收养；采用；采取
adult	n.成年人
advance	vi.前进；提高
advanced	a.先进的；高级的
advantage	n.优点，优势；好处
adventure	n.冒险；惊险活动
adverb	n.副词
advertisement	n.广告；公告；登广告
advice	n.劝告；忠告；意见
advisable	n.明智的；可取的
advise	vt.劝告；建议；通知
aeroplane	n.飞机
affair	n.事情，事件；事务
affect	vt.影响；感动
affection	n.慈爱，爱；爱慕
afford	vt.担负得起…；提供
afraid	a.害怕的；担心的
Africa	n.非洲
African	a.非洲的
after	prep.在…以后；次于
afternoon	n.下午，午后
afterward	ad.后来，以后
again	ad.又一次；而且
against	prep.倚在；逆，对着
age	n.年龄；时代
agency	n.经办；代理；代理处
agent	n.代理人，代理商
aggressive	a.侵略的；好斗的
ago	ad.以前
agony	n.极度痛苦
agree	vi.同意；持相同意见
agreement	n.协定，协议；同意
agriculture	n.农业，农艺；农学
ahead	ad.在前；向前；提前
aid	n.帮助，救护；助手
aim	vi.瞄准，针对；致力
air	n.空气；空中；外观
aircraft	n.飞机，飞行器
airline	n.航空公司；航线
airplane	n.飞机
airport	n.机场，航空站
alarm	n.惊恐，忧虑；警报
alcohol	n.酒精，乙醇
alike	a.同样的，相同的
alive	a.活着的；活跃的
all	a.全部的
allow	vt.允许，准许；任
alloy	n.合金；(金属的)成色
almost	ad.几乎，差不多
alone	a.单独的
along	prep.沿着
aloud	ad.出声地，大声地
alphabet	n.字母表，字母系统
already	ad.早已，已经
also	ad.亦，也；而且，还
alter	vt.改变，变更；改做
alternative	n.替换物；取舍，抉择
although	conj.尽管，虽然
altitude	n.高，高度；高处
altogether	ad.完全；总而言之
aluminium	n.铝
always	ad.总是，一直；永远
a.m	(缩)上午，午前
amaze	vt.使惊奇，使惊愕
ambition	n.雄心，抱负，野心
ambulance	n.救护车；野战医院
America	n.美洲；美国
American	a.美洲的
among	prep.在…之中
amongst	prep在…之中(=among)
amount	n.总数；数量；和
ampere	n.安培
amplify	vt.放大，增强；扩大
amuse	vt.逗…乐；给…娱乐
analyse	vt.分析，分解，解析
analysis	n.分析，分解，解析
ancestor	n.祖宗，祖先
anchor	n.锚
ancient	a.古代的，古老的
and	conj.和，又，并，则
angel	n.天使，神差，安琪儿
anger	n.怒，愤怒
angle	n.角，角度
angry	a.愤怒的，生气的
animal	n.动物，兽
ankle	n.踝，踝节部
announce	vt.宣布，宣告，发表
announcer	n.宣告者；播音员
annoy	vt.使恼怒；打搅
annual	a.每年的
another	a.再一个的；别的
answer	vt.回答；响应；适应
ant	n.蚂蚁
anticipate	vt.预料，预期，期望
anxiety	n.焦虑，忧虑；渴望
anxious	a.忧虑的；渴望的
any	a.什么，一些；任何的
anybody	prep.任何人
anyhow	ad.无论如何
anyone	pron.任何人
anything	pron.任何事物；一切
anyway	ad.无论如何
anywhere	ad.在什么地方
apart	ad.相隔；分开；除去
apartment	n.一套公寓房间
apologize	vi.道歉，谢罪，认错
apology	n.道歉，认错，谢罪
apparatus	n.器械，仪器；器官
apparent	a.表面上的；明显的
appeal	vi.&n.呼吁；申述
appear	vi.出现；来到；似乎
appearance	n.出现，来到；外观
appetite	n.食欲，胃口；欲望
apple	n.苹果，苹果树
appliance	n.用具，器具，器械
applicable	a.能应用的；适当的
application	n.请求，申请；施用
apply	vt.应用，实施，使用
appoint	vt.任命，委任；约定
appointment	n.任命；约定，约会
appreciate	vt.欣赏；领会；感谢
approach	vt.向…*近
appropriate	a.适当的，恰当的
approval	n.赞成，同意；批准
approve	vt.赞成，称许；批准
approximate	a.近似的
approximately	ad.近似地，大约
April	n.四月
Arabian	a.阿拉伯的
arbitrary	a.随心所欲的；专断的
architecture	n.建筑学；建筑式样
area	n.面积；地区；领域
argue	vi.争论，争辩，辩论
argument	n.争论，辩论；理由
arise	vi.出现；由…引起
arithmetic	n.算术，四则运算
arm	n.臂；臂状物；武器
army	n.军队；陆军
around	prep.在…周围
arouse	vt.引起，唤起；唤醒
arrange	vt.筹备；整理；调解
arrangement	n.整理，排列；安排
arrest	vt.逮捕，拘留；阻止
arrival	n.到达；到来；到达者
arrive	vi.到达；来临；达到
arrow	n.箭；箭状物
art	n.艺术，美术；技术
article	n.文章；条款；物品
artificial	a.人工的；娇揉造作的
artist	n.艺术家，美术家
artistic	a.艺术的；艺术家的
as	conj.当…的时候
ash	n.灰，灰末；骨灰
ashamed	a.惭愧(的)；羞耻(的)
Asia	n.亚洲
Asian	a.亚洲的
aside	ad.在旁边，到旁边
ask	vt.问；要求；邀请
asleep	a.睡着的，睡熟的
aspect	n.方面；样子，外表
assemble	vt.集合，召集；装配
assembly	n.集合；集会；装配
assess	vt.对(财产等)估价
assign	vt.指派；分配；指定
assignment	n.任务，指定的作业
assist	vt.援助，帮助；搀扶
assistant	n.助手，助理；助教
associate	vi.交往
association	n.协会，团体；联合
assume	vt.假定；承担；呈现
assure	vt.使确信；向…保证
astonish	vt.使惊讶，使吃惊
astronaut	n.宇宙航行员，宇航员
at	prep.在…里；在…时
athlete	n.运动员；田径运动员
Atlantic	a.大西洋的
atmosphere	n.大气；空气；气氛
atmospheric	a.大气的；大气层的
atom	n.原子；微粒；微量
atomic	a.原子的；原子能的
attach	vt.缚，系，贴；附加
attack	vt.&vi.&n.攻击，进攻
attain	vt.达到，获得，完成
attempt	vt.尝试，试图
attend	vt.出席；照顾，护理
attention	n.注意，留心；注意力
attentive	a.注意的；有礼貌的
attitude	n.态度，看法；姿势
attract	vt.吸引；引起，诱惑
attraction	n.吸引；吸引力；引力
attractive	a.有吸引力的
attribute	vt.把…归因于
audience	n.听众，观众，读者
August	n.八月
aunt	n.伯母，婶母，姑母
aural	a.耳的，听觉的
Australia	n.澳大利亚
Australian	a.澳大利亚的
author	n.作者，作家
authority	n.当局，官方；权力
auto	n.(口语)汽车
automatic	a.自动的；机械的
automation	n.自动，自动化
automobile	n.汽车，机动车
autumn	n.秋，秋季
auxiliary	a.辅助的；附属的
available	a.可利用的；通用的
avenue	n.林荫道，道路；大街
average	n.平均数
aviation	n.航空，航空学
avoid	vt.避免，躲开；撤消
await	vt.等候，期待
awake	a.醒着的
award	n.奖，奖品；判定
aware	a.知道的，意识到的
away	ad.离开，远离；…去
awful	a.令人不愉快的
awfully	ad.令人畏惧的；很
awkward	a.笨拙的；尴尬的
ax	n.斧子
axis	n.轴，轴线；中心线
baby	n.婴儿；孩子气的人
back	ad.在后；回原处；回
background	n.背景，后景，经历
backward	a.向后的；倒的
bacteria	n.细菌
bad	a.坏的，恶的；严重的
badly	ad.坏，差；严重地
badminton	n.羽毛球
bag	n.袋，包，钱包，背包
baggage	n.行李
bake	vt.烤，烘，焙；烧硬
balance	vt.使平衡；称
ball	n.球，球状物；舞会
balloon	n.气球，玩具气球
banana	n.香蕉；芭蕉属植物
band	n.乐队；带；波段
bang	n.巨响，枪声；猛击
bank	n.银行；库；岩，堤
banner	n.旗，旗帜，横幅
bar	n.酒吧间；条，杆；栅
barber	n.理发师
bare	a.赤裸的；仅仅的
bargain	n.交易
bark	n.吠叫声
barn	n.谷仓；牲口棚
barrel	n.桶；圆筒；枪管
barrier	n.栅栏，屏障；障碍
base	n.基础，底层；基地
basic	a.基本的，基础的
basically	ad.基本上
basin	n.盆，洗脸盆；盆地
basis	n.基础，根据
basket	n.篮，篓，筐
basketball	n.篮球；篮球运动
bat	n.球拍；短棍；蝙蝠
bath	n.浴，洗澡；浴缸
bathe	vt.给…洗澡；弄湿
bathroom	n.浴室；盥洗室
battery	n.电池；一套，一组
battle	n.战役；斗争
bay	n.湾；山脉中的凹处
B.C.	(缩)公元前
be	aux.v.&vi.是，在，做
beach	n.海滩，湖滩，河滩
beam	n.梁；横梁；束，柱
bean	n.豆，蚕豆
bear	n.熊；粗鲁的人
bear	vt.容忍；负担；生育
beard	n.胡须，络腮胡子
beast	n.兽，野兽；牲畜
beat	vt.&vi.打，敲；打败
beautiful	a.美的，美丽的
beauty	n.美，美丽；美人
because	conj.由于，因为
become	vi.变成；成为，变得
bed	n.床，床位；圃；河床
bee	n.蜂，密蜂；忙碌的人
beef	n.牛肉；菜牛
beer	n.啤酒
before	prep.在…以前；向…
beg	vt.&vi.乞求；请求
beggar	n.乞丐，穷人
begin	vi.开始
beginner	n.初学者，生手
beginning	n.开始，开端；起源
behalf	n.利益，维护，支持
behave	vi.表现，举止；运转
behavior	n.行为，举止，态度
behind	prep.在…后面
being	n.存在；生物；生命
belief	n.信任，相信；信念
believe	vt.相信；认为
bell	n.钟，铃，门铃；钟声
belong	vi.属于，附属
beloved	a.为…的爱的
below	prep.在…下面(以下)
belt	n.带，腰带；皮带；区
bench	n.长凳，条凳；工作台
bend	vt.使弯曲
beneath	prep.在…下方
beneficial	a.有利的，有益的
benefit	n.利益；恩惠；津贴
berry	n.浆果(如草莓等)
beside	prep.在…旁边
besides	ad.而且prep.除…之外
best	a.最好的；最大的
bet	vt.&vi.&n.打赌
betray	vt.背叛；辜负；泄漏
better	a.较好的
between	prep.在…中间
beyond	prep.在…的那边
Bible	n.基督教《圣经》
bicycle	n.自行车，脚踏车
big	a.大的，巨大的
bike	n.自行车
bill	n.账单；招贴；票据
billion	num.万亿(英)
bind	vt.捆绑；包扎；装钉
biology	n.生物学；生态学
bird	n.鸟，禽
birth	n.分娩，出生；出身
birthday	n.生日，诞生的日期
biscuit	n.(英)饼干；(美)软饼
bit	n.一点，一些，小片
bite	vt.咬，叮，螫；剌穿
bitter	a.痛苦的；严寒的
bitterly	ad.苦苦地；悲痛地
black	a.黑色的；黑暗的
blackboard	n.黑板
blade	n.刀刃，刀片；叶片
blame	vt.责备，把…归咎于
blank	a.空白的
blanket	n.毛毯，毯子，羊毛毯
blast	n.爆炸，冲击波
blaze	n.火；闪光
bleed	vi.出血，流血；泌脂
blend	vt.&vi.&n.混和
bless	vt.为…祝福
blind	a.瞎的；盲目的
block	n.街区
blood	n.血，血液；血统
bloom	n.花；开花，开花期
blossom	n.花，开花
blow	vi.吹，吹动；吹响
blue	a.蓝色的
board	n.板
boast	vi.自夸
boat	n.小船，艇；渔船
body	n.身体；主体；尸体
boil	vi.沸腾；汽化vt.煮沸
bold	a.大胆的；冒失的
bolt	n.螺栓；插销
bomb	n.炸弹
bond	n.联结，联系；公债
bone	n.骨，骨骼
book	n.书，书籍
boot	n.靴子，长统靴
booth	n.货摊；公用电话亭
border	n.边，边缘；边界
bore	vt.使厌烦；钻，挖
born	a.天生的；出生的
borrow	vt.借，借用，借人
bosom	n.胸，胸部；内心
boss	n.老板，上司
both	pron.两者(都)
bother	vt.烦扰，迷惑
bottle	n.瓶，酒瓶；一瓶
bottom	n.底，底部，根基
bough	n.树枝
bounce	vi.反跳，弹起；跳起
bound	a.一定的；有义务的
boundary	n.分界线，办界
bow	n.弓；蝴蝶结；鞠躬
bowl	n.碗，钵；碗状物
box	n.箱，盒；包箱
box	vi.拳击，打拳
boy	n.男孩，少年；家伙
brain	n.脑，脑髓；脑力
brake	n.闸，刹车
branch	n.树枝；分部；分科
brand	n.商品；烙印
brandy	n.白兰地酒
brass	n.黄铜；黄铜器
brave	a.勇敢的，华丽的
bread	n.面包；食物，粮食
breadth	n.宽度，幅度；幅面
break	vt.打破；损坏；破坏
breakfast	n.早饭，早餐
breast	n.乳房；胸脯，胸膛
breath	n.气息，呼吸；气味
breathe	vi.呼吸
breed	n.品种
breeze	n.微风，和风
brick	n.砖，砖块；砖状物
bridge	n.桥，桥梁；桥牌
brief	a.简短的；短暂的
bright	a.明亮的；聪明的
brighten	vt.使发光；使快活
brilliant	a.光辉的；卓越的
brim	n.边，边缘；帽沿
bring	vt.带来；引出；促使
brisk	a.活泼的；清新的
bristle	n.短而硬的毛；鬃毛
Britain	n.不列颠，英国
British	a.不列颠的，英联邦的
brittle	a.脆的；易损坏的
broad	a.宽的，阔的；广泛的
broadcast	n.广播，播音
broken	a.被打碎的，骨折的
bronze	n.青铜；青铜制品
brood	n.同窝幼鸟
brook	n.小河，溪流
broom	n.扫帚
brother	n.兄弟；同事，同胞
brow	n.额；眉，眉毛
brown	n.褐色，棕色
bruise	n.青肿，伤痕；擦伤
brush	n.刷子，毛刷；画笔
brute	n.禽兽，畜生
bubble	n.泡
bucket	n.水桶；吊桶；铲斗
bud	n.芽，萌芽；蓓蕾
build	vt.建筑；建立；创立
building	n.建筑物，大楼；建筑
bulb	n.电灯泡；球状物
bulk	n.物体，容积，大批
bull	n.公牛；雄的象
bullet	n.枪弹，子弹，弹丸
bunch	n.束，球，串；一群
bundle	n.捆，包，束；包袱
burden	n.担子，重担；装载量
bureau	n.局，司，处；社，所
burn	vi.烧，燃烧
burst	vt.使爆裂
bury	vt.埋葬，葬；埋藏
bus	n.公共汽车
bush	n.灌木，灌木丛，矮树
business	n.商业，生意；事务
busy	a.忙的，繁忙的
but	conj.但是，可是
butcher	n.屠夫；屠杀者
butter	n.黄油；奶油
butterfly	n.蝴蝶
button	n.扣子；按钮
buy	vt.买，购买
by	prep.在…旁；被，由
cabbage	n.洋白菜，卷心菜
cabin	n.小屋；船舱，机舱
cabinet	n.橱，柜；内阁
cable	n.缆，索；电缆；电报
cafe	n.咖啡馆；小餐厅
cafeteria	n.自助食堂
cage	n.笼；鸟笼，囚笼
cake	n.饼，糕，蛋糕
calculate	vt.计算；估计；计划
calculation	n.计算，计算结果
calculator	n.计算器，计算者
calendar	n.日历，历书；历法
call	vt.把…叫做；叫，喊
calm	a.静的，平静的
camel	n.骆驼
camera	n.照相机，摄影机
camp	n.野营，营地，兵营
campaign	n.战役；运动
campus	n.校园，学校场地
can	aux.v.能，会，可能
can	n.罐头，听头；容器
Canada	n.加拿大
Canadian	a.加拿大的
canal	n.运河；沟渠；管
cancel	vt.取消，撤消；删去
cancer	n.癌，癌症，肿瘤
candidate	n.候选人；投考者
candle	n.蜡烛；烛形物；烛光
candy	n.糖果；砂糖结晶
cannon	n.大炮，火炮；榴弹炮
canoe	n.独木舟，皮艇，划子
canteen	n.小卖部；临时餐室
canvas	n.粗帆布；一块油画布
cap	n.帽子，便帽；帽状物
capable	a.有能力的，有才能的
capacity	n.容量；能力；能量
capital	n.资本，资金；首都
captain	n.陆军上尉；队长
captive	n.俘虏，被监禁的人
capture	vt.捕获，俘获；夺得
car	n.汽车，小汽车，轿车
carbon	n.碳
card	n.卡，卡片，名片
care	vi.关心，介意
career	n.生涯，职业，经历
careful	a.仔细的；细致的
careless	a.粗心的，漫不经心的
cargo	n.船货，货物
carpenter	n.木工，木匠
carpet	n.地毯，毡毯，毛毯
carriage	n.客车厢；四轮马车
carrier	n.运输工具；运载工具
carrot	n.胡罗卜
carry	vt.携带；运载；传送
cart	n.二轮运货马车
carve	vt.刻，雕刻；切开
case	n.情况；事实；病例
case	n.箱(子)，盒(子)，套
cash	n.现金，现款
cassette	n.盒式录音带；盒子
cast	vt.投，扔，抛；浇铸
castle	n.城堡；巨大建筑物
casual	a.偶然的；随便的
cat	n.猫，猫科，猫皮
catalog	n.目录，目录册
catch	vt.捉住；赶上；领会
cathedral	n.总教堂；大教堂
cattle	n.牛；牲口，家畜
cause	n.原因，理由；事业
cave	n.山洞，洞穴，窑洞
cease	vi.&vi.&n.停止，停息
ceiling	n.天花板，顶蓬
celebrate	vt.庆祝；歌颂，赞美
cell	n.细胞；小房间
cellar	n.地窑，地下室
cement	n.水泥；胶泥
cent	n.分；分币；百
centigrade	a.百分度的
centimetre	n.公分，厘米
central	a.中心的；主要的
centre	n.中心；中枢
century	n.世纪，百年
ceremony	n.典礼，仪式；礼节
certain	a.确实的；肯定的
certainly	ad.一定，必定；当然
certainty	n.必然；肯定
certificate	n.证书，证件，执照
chain	n.链，链条，项圈
chair	n.椅子；主席
chairman	n.主席；议长，会长
chalk	n.白垩；粉笔
challenge	n.挑战；要求，需要
chamber	n.会议室；房间；腔
champion	n.冠军，得胜者
chance	n.机会，机遇；可能性
change	n.改变，变化；零钱
channel	n.海峡；渠道；频道
chapter	n.章，回，篇
character	n.性格；特性；角色
characteristic	a.特有的
charge	vt.索价；控告
charity	n.施舍；慈善事业
charming	a.迷人的，可爱的
chart	n.图，图表；海图
chase	n.追逐，追赶，追求
cheap	a.廉价的；劣质的
cheat	vt.骗取；哄
check	vt.检查；制止
cheek	n.面颊，脸蛋
cheer	vt.使振作；欢呼
cheerful	a.快乐的，愉快的
cheese	n.乳酪，干酪
chemical	a.化学的
chemist	n.化学家；药剂师
chemistry	n.化学
cheque	n.支票
cherry	n.樱桃；樱桃树
chess	n.棋；国际象棋
chest	n.胸腔，胸膛；箱子
chew	vt.咀嚼，嚼碎
chicken	n.小鸡，小鸟；鸡肉
chief	a.主要的；首席的
child	n.小孩，儿童；儿子
childhood	n.童年，幼年；早期
childish	a.孩子的；幼稚的
chill	vt.使变冷
chimney	n.烟囱，烟筒；玻璃罩
chin	n.颏，下巴
China	n.中国
china	n.瓷器，瓷料
Chinese	a.中国的
chocolate	n.巧克力；巧克力糖
choice	n.选择，抉择
choke	vt.使窒息；塞满
choose	vt.选择，挑选；情愿
chop	vt.砍，劈；切细vi.砍
Christian	n.基督教徒；信徒
Christmas	n.圣诞节
church	n.教堂，礼拜堂；教会
cigarette	n.香烟，纸烟，卷烟
cinema	n.电影院；电影，影片
circle	n.圆，圆周；圈子
circuit	n.电路；环行；巡行
circular	a.圆的；循环的
circulate	vt.使循环
circumference	n.圆周，周长，圆周线
circumstance	n.情况，条件；境遇
citizen	n.公民；市民，居民
city	n.城市，都市
civil	a.公民的；文职的
civilization	n.文明，文化；开化
civilize	vt.使文明；教育
claim	vt.声称，主张；索取
clap	vi.拍手
clarify	vt.澄清，阐明
clasp	n.扣子，钩子；别针
class	n.班，班级；阶级
classical	a.古典的；经典的
classification	n.分类；分级；分类法
classify	vt.把…分类
classmate	n.同班同学
classroom	n.教室，课堂
claw	n.爪，脚爪，螯
clay	n.粘土，泥土；肉体
clean	a.清洁的；纯洁的
clear	a.清晰的
clearly	ad.明白地，清晰地
clerk	n.店员；办事员，职员
clever	a.聪明的；机敏的
cliff	n.悬崖，峭壁
climate	n.气候；风土，地带
climb	vi.攀登，爬
cloak	n.斗篷；覆盖(物)
clock	n.钟，仪表
close	vt.关，闭；结束
closely	ad.紧密地，接近地
cloth	n.布；衣料；桌布
clothe	vt.给…穿衣服
clothes	n.衣服，服装；被褥
clothing	n.衣服，被褥
cloud	n.云；云状物；阴影
cloudy	a.多云的；云一般的
club	n.俱乐部，夜总会
clue	n.线索，暗示，提示
clumsy	a.笨拙的；愚笨的
coach	n.长途公共汽车
coal	n.煤，煤块
coarse	a.粗的，粗糙的
coast	n.海岸，海滨(地区)
coat	n.外套，上衣；表皮
cock	n.公鸡；雄禽；旋塞
code	n.准则；法典；代码
coffee	n.咖啡，咖啡茶
coil	n.(一)卷；线圈
coin	n.硬币；铸造(硬币)
cold	a.冷的；冷淡的
collapse	vi.倒坍；崩溃，瓦解
collar	n.衣领，项圈
colleague	n.同事，同僚
collect	vt.收集
collection	n.搜集，收集；收藏品
collective	a.集体的；集合性的
college	n.学院；大学
collision	n.碰撞；冲突
colonel	n.陆军上校；中校
colony	n.殖民地；侨居地
color	n.颜色，彩色；颜料
column	n.柱，支柱，圆柱
comb	n.梳子
combination	n.结合，联合；化合
combine	vt.使结合；兼有
come	vi.来，来到；出现
comfort	n.舒适；安慰
comfortable	a.舒适的，安慰的
command	vt.命令，指挥；控制
commander	n.司令官，指挥员
comment	n.评论，意见；注释
commerce	n.商业，贸易；社交
commercial	a.商业的；商品化的
commission	n.委任状；委员会
commit	vt.犯(错误);干(坏事)
committee	n.委员会；全体委员
common	a.普通的；共同的
commonly	ad.普通地，一般地
communicate	vi.通讯；传达；传播
communication	n.通讯；传达；交通
communism	n.共产主义
communist	n.共产党员
community	n.社区；社会；公社
companion	n.同伴；共事者；伴侣
company	n.公司，商号；同伴
comparative	a.比较的，相对的
compare	vt.比较，对照；比作
comparison	n.比较，对照；比似
compass	n.罗盘，指南针；圆规
compel	vt.强迫，迫使屈服
compete	vi.比赛；竞争；对抗
competent	a.有能力的；应该做的
competition	n.竞争，比赛
compile	vt.编辑，编制，搜集
complain	vi.抱怨，拆苦；控告
complaint	n.抱怨；怨言；控告
complete	a.完整的；完成的
completely	ad.十分，完全地
complex	a.结合的；复杂的
complicate	vt.使复杂；使陷入
complicated	a.复杂的，难懂的
component	n.组成部分；分；组件
compose	vt.组成，构成；创作
composition	n.构成；作品；写作
compound	n.化合物；复合词
comprehension	n.理解，理解力；领悟
comprehensive	a.广泛的；理解的
compress	vt.压紧，压缩
comprise	vt.包含，包括；构成
compromise	n.妥协，和解
compute	vt.计算，估计，估算
computer	n.计算机，电脑
comrade	n.同志，亲密的同伴
conceal	vt.把…隐藏起来
concentrate	vt.集中；聚集；浓缩
concentration	n.集中；专注；浓缩
concept	n.概念，观念，设想
concern	n.关心，挂念；关系
concerning	prep.关于
concert	n.音乐会，演奏会
conclude	vt.推断出；结束
conclusion	n.结论，推论；结尾
concrete	n.混凝土；具体物
condemn	vt.谴责，指责；判刑
condense	vt.压缩，使缩短
condition	n.状况，状态；环境
conduct	n.举止，行为；指导
conductor	n.售票员；(乐队)指挥
conference	n.会议，讨论会
confess	vt.供认，承认；坦白
confidence	n.信任；信赖；信心
confident	n.确信的，自信的
confine	vt.限制；禁闭
confirm	vt.证实，肯定；批准
conflict	n.争论；冲突；斗争
confuse	vt.使混乱，混淆
confusion	n.混乱；骚乱；混淆
congratulate	vt.祝贺，向…道喜
congratulation	n.祝贺；祝贺词
congress	n.大会；国会，议会
conjunction	n.接合，连接；连接词
connect	vt.连接，连结；联系
connection	n.连接，联系；连贯性
conquer	vt.征服，战胜；破除
conquest	n.攻取，征服；克服
conscience	n.良心，道德心
conscious	a.意识到的；有意的
consciousness	n.意识，觉悟；知觉
consent	n.同意，赞成
consequence	n.结果，后果
consequently	ad.因此，因而，所以
conservation	n.保存，保护；守恒
conservative	a.保守的
consider	vt.认为；考虑；关心
considerable	a.相当大的；重要的
considerate	a.考虑周到的；体谅的
consideration	n.考虑，思考；体贴
consist	vi.由…组成；在于
consistent	a.坚持的，一贯的
constant	a.经常的；永恒的
constitution	n.章程；体质；构造
construct	vt.建造；建设；构筑
construction	n.建造；建筑；建筑物
consult	vt.请教，查阅
consume	vt.消耗，消费；消灭
consumption	n.消耗量；消耗
contact	vt.使接触；与…联系
contain	vt.包含，容纳；等于
container	n.容器；集装箱
contemporary	a.当代的，同时代的
contempt	n.轻蔑；藐视；受辱
content	n.内容，目录；容量
content	a.满意的，满足的
contest	vt.争夺，争取；辩驳
continent	n.大陆；陆地；洲
continual	a.不断的；连续的
continue	vt.继续，连续；延伸
continuous	a.连续不断的，持续的
contract	n.契约，合同；婚约
contradiction	n.矛盾，不一致；否认
contrary	a.相反的
contrast	n.对比，对照，悬殊
contribute	vt.捐献，捐助；投稿
control	vt.控制，克制
convenience	n.便利，方便；厕所
convenient	a.便利的；近便的
convention	n.习俗，惯例；公约
conventional	a.普通的；习惯的
conversation	n.会话，非正式会谈
conversely	ad.相反地
conversion	n.转变，转化；改变
convert	vt.使转变；使改变
convey	vt.传送；运送；传播
convince	vt.使确信，使信服
cook	vt.烹调，煮
cool	a.凉的，冷静的
cooperate	vi.合作，协作；配合
coordinate	vt.使协调，调节
cope	vi.对付，应付
copper	n.铜；铜币，铜制器
copy	n.抄件
cord	n.细绳，粗线，索
cordial	a.真诚的，诚恳的
core	n.果实的心，核心
corn	n.谷物；(英)小麦
corner	n.角；犄角；边远地区
corporation	n.公司，企业；社团
correct	a.正确的
correction	n.改正，纠正，修改
correspond	vi.相符合；相当
correspondent	n.通信者；通讯员
corresponding	a.相应的；符合的
corridor	n.走廊，回廊，通路
cost	n.价格，代价；成本
costly	a.昂贵的；价值高的
cottage	n.村舍，小屋
cotton	n.棉；棉线；棉布
cough	vi.咳，咳嗽
could	aux.v.(can的过去式)
council	n.理事会，委员会
count	vt.计算
counter	n.柜台；计数器
country	n.国家，国土；农村
countryside	n.乡下，农村
county	n.英国的郡，美国的县
couple	n.夫妇；(一)对；几个
courage	n.勇气，胆量，胆识
course	n.课程；过程；一道菜
court	n.法院，法庭；庭院
cousin	n.堂(或表)兄弟(姐妹)
cover	vt.盖，包括
cow	n.母牛，奶牛；母兽
coward	n.懦夫；胆怯者
crack	n.裂缝，裂纹
craft	n.工艺；手艺，行业
crane	n.起重机，摄影升降机
crash	vi.碰撞，坠落
crawl	vi.爬，爬行
crazy	a.疯狂的，荒唐的
cream	n.奶油，乳脂；奶油色
create	vt.创造；引起，产生
creative	a.创造性的，创作的
creature	n.生物，动物，家畜
credit	n.信用贷款；信用
creep	vi.爬行；缓慢地行进
crew	n.全体船员
cricket	n.板球；蟋蟀
crime	n.罪，罪行；犯罪
criminal	n.犯人，罪犯，刑事犯
cripple	n.跛子；残废的人
crisis	n.危机；存亡之际
critic	n.批评家，爱挑剔的人
critical	a.决定性的；批评的
criticism	n.批评；批判；评论
criticize	vt.批评；评论；非难
crop	n.农作物，庄稼；一熟
cross	vt.穿过；使交*
crow	n.鸦，乌鸦
crowd	n.群；大众；一伙人
crown	n.王冠，冕；花冠
crude	a.简陋的；天然的
cruel	a.残忍的，残酷的
crush	vt.压碎，碾碎；镇压
crust	n.面包皮；硬外皮
cry	vi.哭，哭泣；叫喊
crystal	n.水晶，结晶体；晶粒
cube	n.立方形；立方
cubic	a.立方形的；立方的
cucumber	n.黄瓜
cultivate	vt.耕；种植；培养
culture	n.文化，文明；教养
cunning	a.狡猾的，狡诈的
cup	n.杯子；(一)杯；奖杯
cupboard	n.碗柜，碗碟橱；食橱
cure	vt.医治；消除
curiosity	n.好奇，好奇心；珍品
curious	a.好奇的；稀奇古怪的
curl	n.卷毛；螺旋
current	a.当前的；通用的
curse	n.诅咒，咒骂；天谴
curtain	n.帘，窗帘；幕(布)
curve	n.曲线；弯
cushion	n.垫子，坐垫，*垫
custom	n.习惯，风俗；海关
customer	n.顾客，主顾
cut	vt.切，割，剪；减少
cycle	n自行车，循环
daily	a.每日的
dairy	n.牛奶场；乳制品
dam	n.水坝，水堤；障碍物
damage	vt.损害，毁坏
damp	a.潮湿的，有湿气的
dance	vi.跳舞；摇晃
danger	n.危险；危险事物
dangerous	a.危险的，不安全的
dare	vt.&aux.v.敢；竟敢
daring	a.大胆的，勇敢的
dark	a.暗的；黑色的
darling	n.亲爱的人；宠儿
dash	vt.使猛撞；溅
data	n.数据;
date	n.日期
daughter	n.女儿
dawn	n.黎明；开端
day	n.(一)天，白昼，白天
daylight	n.白昼，日光；黎明
dead	a.死的，无生命的
deadly	a.致命的，死一般的
deaf	a.聋的；不愿听的
deal	n.买卖；待遇
dear	a.亲爱的
death	n.死，死亡；灭亡
debate	n.&vi.争论，辩论
debt	n.债，债务，欠债
decade	n.十年，十年期
decay	vi.腐烂；衰败
deceit	n.欺骗，欺诈
deceive	vt.欺骗，蒙蔽，行骗
December	n.十二月
decent	a.正派的；体面的
decide	vt.决定，决心；解决
decision	n.决定，决心；果断
deck	n.甲板；舱面；层面
declare	vt.断言；声明；表明
decorate	vt.装饰，装璜，修饰
decrease	vi.&n.减少，减少
deduce	vt.演绎，推论，推断
deed	n.行为；功绩；契约
deep	a.深的；纵深的
deepen	vt.加深
deer	n.鹿
defeat	vt.战胜，击败；挫败
defect	n.缺点，缺陷，欠缺
defence	n.防御；防务；辩护
defend	vt.保卫，防守
define	vt.给…下定义；限定
definite	a.明确的；肯定的
definitely	ad.一定地，明确地
definition	n.定义，释义；定界
degree	n.程度；度；学位
delay	vt.推迟；耽搁；延误
delete	vt.删除；擦掉
delegation	n.代表团
delicate	a.纤细的；易碎的
delicious	a.美味的，怡人的
delight	n.快乐
deliver	vt.投递，送交；发表
delivery	n.投递；交付；分娩
demand	vt.要求；需要；询问
democracy	n.民主，民主制
democratic	a.民主的，民主政体的
demonstrate	vt.说明；论证；表露
dense	a.密集的；浓厚的
density	n.密集，稠密；密度
deny	vt.否定；拒绝相信
depart	vi.离开，起程；出发
department	n.部，司，局，处，系
departure	n.离开，出发，起程
depend	vi.依*，依赖；相信
dependent	a.依*的，依赖的
deposit	vt.使沉淀；存放
depress	vt.使沮丧；按下
depth	n.深度；深厚；深处
derive	vt.取得
descend	vi.下来，下降；下倾
describe	vt.形容；描写，描绘
description	n.描写，形容；种类
desert	n.沙漠
deserve	vt.应受，值得
design	vt.设计
desirable	a.值得相望的；可取的
desire	vt.相望；要求
desk	n.书桌，办公桌
despair	n.绝望
desperate	a.拼死的；绝望的
despise	vt.鄙视，蔑视
despite	prep.不管，不顾
destination	n.目的地，终点；目标
destroy	vt.破坏；消灭；打破
destruction	n.破坏，毁灭，消灭
detail	n.细节；枝节；零件
detect	vt.察觉，发觉；侦察
detection	n.察觉，发觉；侦察
determination	n.决心；决定；确定
determine	vt.决定；查明；决心
develop	vt.发展；形成；开发
development	n.发展；开发；生长
device	n.器械，装置；设计
devil	n.魔鬼，恶魔
devise	vt.设计，发明
devote	vt.将…奉献，致力于
dew	n.露，露水
diagram	n.图解，图表，简图
dial	n.钟面；拨号盘
dialect	n.方言，土语，地方话
dialog	n.对话，对白
diameter	n.直径
diamond	n.金钢石，钻石；菱形
diary	n.日记，日记簿
dictate	vt.&vi.口授；命令
dictation	n.口授笔录，听写
dictionary	n.词典，字典
die	vi.死，死亡；灭亡
differ	vi.不同，相异
difference	n.差别；差；分歧
different	a.差异的；各种的
difficult	a.困难的；难对付的
difficulty	a.困难；难事；困境
dig	vt.掘，挖；采掘
digest	vt.消化；领会
digital	a.数字的，计数的
diligent	a.勤勉的，勤奋的
dim	a.昏暗的；朦胧的
dimension	n.尺寸，尺度；面积
dinner	n.正餐，主餐；宴会
dip	vt.浸，蘸
direct	a.直接的；直率的
direction	n.方向，方位；指导
directly	ad.直接地；立即
director	n.指导者；理事；导演
dirt	n.尘，土；污物，污垢
dirty	a.脏的；下流的
disable	vt.使无能，使伤残
disadvantage	n.不利，不利地位
disagree	vi.有分歧；不一致
disappear	vi.不见，失踪；消失
disappoint	vt.使失望，使受挫折
disaster	n.灾难，灾祸；天灾
disk	n.圆盘，唱片；磁盘
discard	vt.丢弃，抛弃，遗弃
discharge	vt.释放；排出
discipline	n.纪律；训练
disclose	vt.揭开，揭发；透露
discourage	vt.使泄气，使灰心
discover	vt.发现；暴露，显示
discovery	n.发现；被发现的事物
discuss	vt.讨论，谈论；论述
discussion	n.讨论，谈论；论述
disease	n.病，疾病；病害
disguise	vi.隐瞒，掩埋
disgust	n.厌恶，憎恶
dish	n.碟，盘子；菜肴
dishonour	n.不光彩；丢脸的人
dislike	vt.&n.不喜爱，厌恶
dismiss	vt.不再考虑；解雇
disorder	n.混乱，杂乱；骚乱
display	vt.陈列，展览；显示
disposal	n.丢掉，处理，销毁
dispose	vi.去掉，丢掉；销毁
displease	vt.使不愉快，使生气
dispute	vi.争论，争执
dissatisfy	vi.使不满，使不平
dissolve	vt.使溶解；解散
distance	n.距离，间距；远处
distant	a.在远处的，疏远的
distinct	a.与其他不同的
distinction	n.差别，不同，区分
distinguish	vt.区别，辨别，认别
distress	n.忧虑，悲伤；不幸
distribute	vt.分发，分送；分布
distribution	n.分发，分配；分布
district	n.区；地区，区域
disturb	vt.打扰，扰乱；弄乱
ditch	n.沟，沟渠，渠道
dive	vi.跳水；潜水；俯冲
diverse	a.不一样的，相异的
divide	vt.分；分配；分开
division	n.分，分配；除法
divorce	n.离婚，离异
do	aux.v.
dock	n.船坞；码头；船厂
doctor	n.医生，医师；博士
document	n.公文，文件；证件
dog	n.狗，犬，犬科动物
dollar	n.元(货币单位)
domestic	a.本国的；家庭的
donkey	n.驴；笨蛋
door	n.门，通道；一家
dorm	n.宿舍
dormitory	n.集体寝室；宿舍
dose	n.剂量，用量；一剂
dot	n.点，圆点
double	a.两倍的；双的
doubt	n.怀疑；疑虑
doubtful	a.难以预测的；怀疑的
doubtless	ad.无疑地；很可能
down	ad.向下，在下面
downstairs	ad.在楼下
downward	a.向下的
dozen	n.一打，十二个
draft	n.草稿；汇票
drag	vt.拖，拉；拖曳
dragon	n.龙；凶暴的人
drain	vt.排去；放水
drama	n.一出戏剧，剧本
dramatic	a.引人注目的，戏剧的
draw	vt.画，划；拖；拨出
drawer	n.抽屉
drawing	n.图画，素描；绘图
dread	n.畏惧；恐怖
dream	n.梦；梦想
dress	n.女服，童装；服装
drift	vi.漂流，漂泊
drill	n.钻头；操练
drink	vt.饮
drip	vi.滴下；漏水
drive	vt.驾驶；打入；驱
driver	n.驾驶员，司机
drop	vt.使落下；降低
drought	n.旱灾，干旱
drown	vi.淹死，溺死
drug	n.药，药物，药材
drum	n.鼓；鼓状物，圆桶
drunk	a.醉的；陶醉的
dry	a.干的，干燥的
duck	n.鸭，雌鸭；鸭肉
due	a.预期的；应给的
dull	a.枯燥的；不鲜明的
dumb	a.哑的；无言的
dump	vt.倾卸，倾倒；倾销
durable	a.耐久的，耐用的
duration	n.持续，持久
during	prep.在…期间
dusk	n.薄暮，黄昏，幽暗
dust	n.尘土，灰尘
duty	n.职责；责任；税
dwelling	n.住处，寓所
dye	vt.染
dying	a.垂死的；临终的
dynamic	a.有活力的；动力的
each	pron.各，各自
eager	a.渴望的，热切的
eagle	n.鹰
ear	n.耳朵；听力，听觉
early	ad.早
earn	vt.赚得，挣得；获得
earnest	a.认真的，诚恳的
earth	n.地球；陆地，地面
earthquake	n.地震；大震荡
ease	n.容易，舒适
easily	ad.容易地；舒适的
east	n.东；东部
eastern	a.东方的；朝东的
easy	a.容易的；安逸的
eat	vt.吃，喝
echo	n.回声，反响
economic	a.经济的，经济学的
economical	a.节约的；经济学的
economy	n.经济；节约，节省
edge	n.边缘，边；刀口
edition	n.版，版本，版次
editor	n.编辑，编者，校订者
educate	vt.教育；培养；训练
education	n.教育；训导；教育学
effect	n.结果；效果，效力
effective	a.有效的；有影响的
efficiency	n.效率；功效，效能
efficient	a.效率高的，有能力的
effort	n.努力；努力的成果
egg	n.蛋，鸡蛋，卵
eight	num.八，八个，第八
eighteen	num.十八，十八个
eighth	num.第八
eighty	num.八十，八十个
either	pron.(两者)任何一个
elaborate	a.复杂的；精心制作的
elastic	n.松紧带
elbow	n.肘，肘部；弯管
elder	a.年龄较大的
elect	vt.选举，推选；选择
election	n.选举，选择权；当选
electric	a.电的，电动的
electrical	a.电的，电气科学的
electricity	n.电，电学；电流
electron	n.电子
electronic	a.电子的
electronics	n.电子学
element	n.成分；要素；元素
elementary	a.基本的；初级的
elephant	n.象
elevator	n.电梯；升降机
eleven	num.十一，十一个
eleventh	num.第十一(个)
eliminate	vt.消灭，消除，排除
elimination	n.消灭，排除，消除
else	ad.其它，另外
elsewhere	ad.在别处，向别处
embarrass	vt.使窘迫，使为难
embrace	vt.拥抱；包括；包围
emerge	vi.出现，涌现；冒出
emergency	n.紧急情况，突然事件
emit	vt.散发；发射；发表
emotion	n.情感，感情；激动
emotional	a.感情的，情绪的
emperor	n.皇帝
emphasis	n.强调，重点，重要性
emphasize	vt.强调，着重
empire	n.帝国
employ	vi.雇用；用；使忙于
employee	n.受雇者，雇员，雇工
employer	n.雇佣者，雇主
employment	n.工业；雇用；使用
empty	a.空的；空洞的
enable	vt.使能够，使可能
enclose	vt.围住，圈起；附上
encounter	vt.遭遇，遇到
encourage	vt.鼓励，支持，助长
end	n.末端；目标
ending	n.结尾，结局；死亡
endless	a.无止境的
endure	vt.忍受；容忍
enemy	n.敌人；仇敌；敌兵
energy	n.活力；精力；能
enforce	vt.实施，执行；强制
engage	vt.使从事于；聘用
engine	n.发动机，引擎；机车
engineer	n.工程师，技师
engineering	n.工程，工程学
England	n.英格兰；英国
English	n.英语
Englishman	n.英国男子
enjoy	vt.享受；欣赏，喜爱
enlarge	vt.扩大，扩展；放大
enormous	a.巨大的，庞大的
enough	a.足够的
ensure	vt.保证；保护；赋予
enter	vt.走进，进入；参加
entertain	vt.使欢乐；招待
enthusiasm	n.热情，热心，热忱
enthusiastic	a.热情的，热心的
entire	a.全部的，整个的
entitle	vt.给…权利(或资格)
entrance	n.入口，门口；进入
entry	n.入口处；登记；进入
envelope	n.信封；封套；封皮
environment	n.环境，外界；围绕
envy	vt.&n.妒忌；羡慕
equal	a.相等的；平等的
equality	n.等同，平等；相等
equation	n.方程(式)；等式
equip	vt.装备，配备
equipment	n.装备，设备，配备
equivalent	a.相等的；等量的
era	n.时代，年代；纪元
erect	vt.建造；使竖立
error	n.错误，谬误；差错
escape	vi.逃跑；逸出
especially	ad.特别，尤其，格外
essay	n.短文，散文，小品文
essential	a.必要的，本质的
establish	vt.建立，设立；确立
establishment	n.建立，设立，确立
estimate	vt.估计，评价
Europe	n.欧洲
European	a.欧洲的
evaluate	vt.评价，估…的价
evaporate	vt.使蒸发
eve	n.前夜，前夕，前一刻
even	ad.甚至；甚至更，还
even	a.均匀的；平的
evening	n.傍晚，黄昏，晚上
event	n.事件，大事；事变
eventually	ad.终于；最后
ever	ad.在任何时候；曾经
every	a.每一的；每隔…的
everybody	pron.每人，人人
everyday	a.每天的，日常的
everyone	pron.每人，人人
everything	pron.每件事，事事
everywhere	ad.到处，处处
evidence	n.根据；证据，证人
evident	a.明显的，明白的
evil	n.邪恶；祸害
evolution	n.进化，演化；发展
evolve	vt.使进化；使发展
exact	a.确切的；精确的
exactly	ad.确切地；恰恰正是
exaggerate	vt.&vi.夸大，夸张
exam	n.考试；检查，细查
examination	n.考试；检查，细查
examine	vt.检查，仔细观察
example	n.例子，实例；模范
exceed	vt.超过，胜过；超出
exceedingly	ad.极端地，非常
excellent	a.优秀的，杰出的
except	prep.除…之外
exception	n.例外，除外
excess	n.超越；过量；过度
excessive	a.过多的，极度的
exchange	vt.交换；交流
excite	vt.使激动；引起
exciting	a.令人兴奋的
exclaim	vi.呼喊；惊叫
exclude	vt.把…排除在外
exclusively	ad.专门地
excursion	n.远足；短途旅行
excuse	vt.原谅；免除
execute	vt.将…处死；实施
executive	a.执行的
exercise	n.锻炼，训练
exert	vt.尽(力)，运用
exhaust	vt.使筋疲力尽；用尽
exhibit	vt.显示；陈列，展览
exhibition	n.展览，陈列；展览会
exist	vi.存在；生存，生活
existence	n.存在，实在；生存
exit	n.出口；退场
expand	vt.扩大；使膨胀
expansion	n.扩大，扩充；扩张
expect	vt.预料，预期；等待
expectation	n.期待，期望，预期
expense	n.花费，消费；费用
expensive	a.昂贵的，花钱多的
experience	n.经验，感受；经历
experiment	n.实验；试验
experimental	a.实验的，试验的
expert	n.专家
explain	vt.解释；为…辩解
explanation	n.解释，说明；辩解
explode	vt.使爆炸
exploit	vt.剥削；利用；开拓
explore	vt.&vi.探险，探索
explosion	n.爆炸，爆发，炸裂
explosive	n.炸药
export	vt.输出，出口；运走
expose	vt.使暴露；揭露
exposure	n.暴露；揭露；曝光
express	vt.表示
expression	n.词句；表达；表情
extend	vt.延长；扩大；致
extension	n.延长部分；伸展
extensive	a.广阔的；广泛的
extent	n.广度；范围；程度
exterior	a.外部的；对外的
external	a.外部的，外面的
extra	a.额外的
extraordinary	a.非同寻常的，特别的
extreme	a.极度的；尽头的
extremely	ad.极端，极其，非常
eye	n.眼睛；眼力；鉴赏力
eyesight	n.视力，目力
facility	n.设备；容易；便利
fact	n.事实；实际，实情
factor	n.因素；因子，系数
factory	n.工厂，制造厂
faculty	n.才能，能力；系，科
fade	vi.褪色；逐渐消失
Fahrenheit	n.华氏温度计
fail	vi.失败；失灵；不能
failure	n.失败；失败的人
faint	a.微弱的；虚弱的
fair	a.公平的；相当的
fair	n.定期集市；博览会
fairly	ad.相当；公平地
faith	n.信任，信心；信仰
faithful	a.忠诚的；如实的
fall	vi.落下；跌倒；陷落
false	a.不真实的；伪造的
fame	n.名声，名望
familiar	a.熟悉的；冒昧的
family	n.家，家庭；家族
famine	n.饥荒；严重的缺乏
famous	a.著名的，出名的
fan	n.(运动等)狂热爱好者
fan	n.扇子，风扇
fancy	n.想象力；设想；爱好
far	a.远的
fare	n.车费，船费，票价
farewell	int.再会
farm	n.农场，农庄；饲养场
farmer	n.农民，农夫；农场主
farther	ad.更远地
fashion	n.样子，方式；风尚
fashionable	a.流行的，时髦的
fast	a.快的；偏快的
fasten	vt.扎牢，扣住
fatal	a.致命的；命运的
fate	n.命运，天数
father	n.父亲；神父；创始人
father-in-law	n.岳父；公公
fatigue	n.疲劳，劳累
fault	n.缺点；过失；故障
faulty	a.有错误的，有缺点的
favour	n.好感；赞同；恩惠
favourable	a.有利的；赞成的
favourite	a.特别受喜爱的
fear	n.害怕；担心
fearful	a.害怕的，可怕的
feasible	a.可行的；可能的
feast	n.盛宴，筵席；节日
feather	n.羽毛；翎毛；羽状物
feature	n.特征，特色；面貌
February	n.二月
federal	a.联邦的；联盟的
fee	n.费，酬金；赏金
feeble	a.虚弱的；微弱的
feed	vt.喂(养)
feedback	n.回授，反馈，反应
feel	vi.有知觉
feeling	n.感情；感觉，知觉
fellow	n.人，家伙；伙伴
female	n.雌性的动物；女子
fence	n.栅栏
fertile	a.肥沃的；多产的
fertilizer	n.肥料
festival	n.节日；音乐节
fetch	vt.拿来；请来，接去
fever	n.发热，发烧；狂热
few	a.很少的；少数的
fibre	n.纤维，纤维质
fiction	n.小说；虚构，杜撰
field	n.田野；田；运动场
fierce	a.凶猛的，狂热的
fifteen	num.十五；十五个
fifth	num.第五
fifty	num.五十，五十个
fight	vi.打(仗)；斗争
figure	n.数字；外形；人物
file	n.档案
fill	vt.装满，盛满；占满
film	n.影片；胶卷；薄层
filter	vt.过滤
final	a.最后的；决定性的
finally	ad.最后；不可更改的
finance	n.财政，金融；财源
financial	a.财政的，金融的
find	vt.找到；发觉；找出
finding	n.发现；调查的结果
fine	a.美好的；纤细的
fine	n.罚金，罚款
finger	n.手指；指状物
finish	vt.完成，结束
fire	n.火；火灾
fireman	n.消防队员；司炉工
firm	n.商行，商号，公司
first	num.第一
fish	n.鱼，鱼肉
fisherman	n.渔民，渔夫，打鱼人
fist	n.拳(头)
fit	vt.适合；安装vi.适合
five	num.五，五个，第五
fix	vt.使固定；决定
flag	n.旗，旗帜；旗舰旗
flame	n.火焰；光辉；热情
flare	vi.闪耀
flash	n.闪光
flat	a.平的，扁平的
flat	n.一套房间；单元住宅
flavour	n.味，味道；风味
fleet	n.舰队；船队，机群
flesh	n.肉，肌肉；肉体
flexible	a.易弯曲的；灵活的
flight	n.航班；飞行；逃跑
float	vi.漂浮
flock	n.羊群，群；大量
flood	n.洪水
floor	n.地板；楼层
flour	n.面粉，粉；粉状物质
flourish	vi.繁荣，茂盛，兴旺
flow	vi.流动；飘垂；涨潮
flower	n.花，花卉；开花
flu	n.流行性感冒
fluent	a.流利的，流畅的
fluid	n.流体，液体
flush	vi.奔流；(脸)发红
fly	n.蝇，苍蝇
focus	vi.聚焦，注视
fog	n.雾；烟雾，尘雾
fold	vt.折叠；合拢
folk	n.人们，家属，亲属
follow	vt.跟随；结果是
following	a.接着的；下列的
fond	a.喜爱的；溺爱的
food	n.食物，食品，养料
fool	n.蠢人，傻子
foolish	a.愚蠢的；鲁莽的
foot	n.脚；最下部；英尺
football	n.足球比赛；足球
footstep	n.脚步；脚步声；足迹
for	prep.为；给；因为
forbid	vt.禁止，不许；阻止
force	vt.强迫
forecast	n.预测，预报
forehead	n.额头，前部
foreign	a.外国的；外来的
foreigner	n.外国人
foremost	a.最初的；第一流的
forest	n.森林；森林地带
forever	ad.永远，总是，老是
forget	vt.忘记，遗忘
forgive	vt.原谅，饶恕，宽恕
fork	n.餐*；*；分*
form	n.形式；形状
formal	a.正式的；礼仪上的
formation	n.形成；构成；形成物
former	a.在前的
formula	n.公式，式
forth	ad.向前；向外，往外
fortnight	n.两星期，十四天
fortunate	a.幸运的，侥幸的
fortunately	ad.幸运地，幸亏
fortune	n.命运，运气；财产
forty	num.四十，第四十
forward	ad.向前；今后，往后
found	vt.创立，创办；建立
foundation	n.基础；地基；基金
fountain	n.泉水，喷泉；源泉
four	num.四，四个，第四
fourteen	num.十四，第十四
fourth	num.第四，四分之一
fox	n.狐狸；狡猾的人
fraction	n.小部分；片断；分数
fragment	n.碎片，破片，碎块
frame	n.框架，框子；构架
framework	n.框架，构架，结构
France	n.法国，法兰西
frank	a.坦白的，直率的
free	a.自由的；空闲的
freedom	n.自由；自主
freely	ad.自由地；直率地
freeze	vi.冻；结冻vt.使结冰
freight	n.货运；货物；运费
French	a.法国的
frequency	n.屡次；次数；频率
frequent	a.时常发生的；经常的
frequently	ad.时常，常常
fresh	a.新的；新鲜的
friction	n.摩擦，摩擦力
Friday	n.星期五
fridge	n.电冰箱
friend	n.朋友，友人
friendly	a.友好的，友谊的
friendship	n.友谊，友好
frighten	vt.使惊恐，吓唬
frog	n.蛙
from	prep.从…来；离开
front	a.前面的
frontier	n.边境；边疆；新领域
frost	n.冰冻，严寒；霜
frown	vi.皱眉，蹙额
fruit	n.水果；果实；成果
fruitful	a.多产的；肥沃的
fry	vt.油煎，油炸，油炒
fuel	n.燃料
fulfil	vt.履行；满足；完成
full	a.满的；完全的
fun	n.乐趣，娱乐；玩笑
function	n.功能；职务；函数
fund	n.资金；基金；存款
fundamental	a.基础的，基本的
funeral	n.葬礼，丧礼，丧葬
funny	a.古怪的；滑稽的
fur	n.软毛；毛皮，裘皮
furious	a.狂怒的；狂暴的
furnace	n.炉子，熔炉；鼓风炉
furnish	vt.供应，提供；装备
furniture	n.家具；装置，设备
further	ad.更远地
furthermore	ad.而且，此外
future	n.将来，未来；前途
gain	vt.获得；增加
gallery	n.长廊，游廊；画廊
gallon	n.加仑
game	n.游戏；比赛；猎物
gang	n.一帮，一伙
gap	n.缺口；间隔；差距
garage	n.车库；加油站
garbage	n.垃圾，污物，废料
garden	n.花园，菜园；公园
gardener	n.园丁，花匠
gas	n.煤气；气体；汽油
gaseous	a.气体的，气态的
gasoline	n.(美)汽油
gasp	vi.气喘，喘息
gate	n.大门；篱笆门
gather	vi.聚集；集合vt.收集
gauge	vt.量，测量
gay	a.快乐的；鲜明的
gaze	vi.凝视，盯，注视
general	a.总的；一般的n.将军
generally	ad.一般地；通常地
generate	vt.发生；引起；生殖
generation	n.一代，一代人；产生
generator	n.发电机；发生者
generous	a.慷慨的；宽厚的
genius	n.天才，天赋，天资
gentle	a.和蔼的；轻柔的
gentleman	n.绅士；有教养的人
gently	ad.有礼貌地；柔和地
genuine	a.真的；真正的
geography	n.地理，地理学
geometry	n.几何，几何学
germ	n.微生物，细菌，幼芽
German	a.德国的
Germany	n.德意志，德国
gesture	n.姿势，手势；姿态
get	vi.变得，成为；到达
ghost	n.鬼，灵魂；鬼魂
giant	n.巨人；巨物
gift	n.礼物，赠品；天赋
girl	n.女孩子，姑娘；女儿
give	vt.做，作；送给
glad	a.高兴的；乐意的
glance	vi.看一下
glare	vi.瞪眼
glass	n.玻璃；玻璃杯
glide	vi.滑动；消逝
glimpse	vt.瞥见
glitter	vi.闪闪发光
globe	n.地球，世界；地界仪
gloomy	a.黑暗的；令人沮丧的
glorious	a.光荣的；壮丽的
glory	n.光荣；荣誉的事
glove	n.手套
glow	n.白热光
glue	n.胶，胶水
go	vi.去；走；变为
goal	n.球门；得分；目的
goat	n.山羊
God	n.神，神像；上帝
gold	n.金；钱财
golden	a.金色的；极好的
golf	n.高尔夫球
good	a.好的；有本事的
goodbye	int.再见，再会
goodness	n.优良，德性，仁慈
goods	n.货物，商品
goose	n.鹅，雌鹅
govern	vt.统治，治理；支配
government	n.政府；治理；政治
governor	n.州长；主管人员
gown	n.长袍，长外衣
grace	n.优美，文雅；雅致
graceful	a.优美的，优雅的
gracious	a.有礼貌的；仁慈的
grade	vt.给…分等级
gradual	a.逐渐的；渐进的
gradually	ad.逐渐地，逐步地
graduate	n.毕业生
grain	n.谷物，谷粒；颗粒
gramme	n.克(重量单位)
grammar	n.语法；语法书
grammatical	a.语法上的
grand	a.宏伟的；重大的
granddaughter	n.孙女，外孙女
grandfather	n.祖父；外祖父
grandmother	n.祖母，外祖母
grandson	n.孙子，外孙子
grant	n.授给物
grape	n.葡萄；葡萄藤
graph	n.(曲线)图，图表
grasp	vt.抓紧；掌握
grass	n.草；牧草；草地
grateful	a.感激的；令人愉快的
gratitude	a.感激，感谢，感恩
grave	n.坟墓
gravity	n.重力，引力；严重性
gray	a.灰色的
great	a.大的；伟大的
greatly	ad.大大地，非常
greedy	a.贪吃的；贪婪的
Greek	a.希腊的
green	a.绿色的
greenhouse	n.温室，玻璃暖房
greet	vt.问候，招呼；反应
greeting	n.问候，招呼，致敬
grey	a.灰色的
grieve	vt.使悲痛
grind	vt.磨(碎)；磨快
grip	vt.握紧，抓牢
groan	vi.哼，呻吟
grocer	n.食品商；杂货商
grocery	n.食品杂货店
gross	a.总的；严重的
ground	n.地；场地；根据
group	n.小组，群
grow	vi.生长；变得；增长
growth	n.增长；增长量；生长
guarantee	n.保证；担保物
guard	vt.守卫；看守
guess	vt.&vi.&n.猜测，推测
guest	n.客人，宾客；旅客
guidance	n.引导，指导，领导
guide	n.导游者
guilty	a.内疚的；有罪的
gulf	n.海湾
gum	n.口香糖；树胶
gun	n.枪，炮，手枪
gunpowder	n.黑色火药；有烟火药
gymnasium	n.体育馆，健身房
habit	n.习惯；习性
habitual	a.习惯性的，惯常的
hair	n.头发，毛发；毛
haircut	n.理发
half	n.半，一半
hall	n.门厅；过道；会堂
halt	vi.停止；立定
hamburger	n.汉堡包，牛肉饼
hammer	n.锤，榔头
hand	n.手；人手；指针
handful	n.一把；少数，一小撮
handkerchief	n.手帕
handle	n.柄，把手
handsome	a.英俊的；相当大的
handwriting	n.笔迹，手迹，书法
handy	a.手边的；便于使用的
hang	vt.挂，悬；吊死
happen	vi.发生；碰巧，恰好
happiness	n.幸福，幸运；快乐
happy	a.快乐的；幸福的
harbour	n.海港，港口
hard	a.硬的；困难的
harden	vt.使变硬
hardly	ad.几乎不，简直不
hardship	n.艰难，困苦
hardware	n.五金器具；硬件
hare	n.野兔
harm	n.伤害，损害
harmful	a.有害的
harmony	n.调合，协调，和谐
harness	vt.治理
harsh	a.严厉的；刺耳的
harvest	n.收获，收成
haste	n.急速，急忙；草率
hasten	vt.催促
hasty	a.急速的；仓促的
hat	n.帽子(一般指有边的)
hatch	vt.孵出
hate	vt.恨，憎恨；不喜欢
hateful	a.可恨的，可恶的
hatred	n.憎恶，憎恨，仇恨
have	v.aux.已经
hawk	n.鹰，隼
hay	n.干草
hazard	n.危险；公害
he	pron.(主格)他
head	n.头；上端
headache	n.头痛；头痛的事
heading	n.标题，题词，题名
headline	n.大字标题；新闻提要
headmaster	n.校长
headquarters	n.司令部；总部
heal	vt.治愈；使和解
health	n.健康，健康状况
healthy	a.健康的；有益健康的
heap	n.(一)堆；大量
hear	vt.听见；审讯；听说
heart	n.心，内心；勇气
heat	n.热，炎热
heating	n.加热，供暖
heaven	n.天堂；天，天空
heavily	ad.重重地；大量地
heavy	a.重的；大的；充满的
hedge	n.篱笆，树篱；障碍物
heel	n.脚后跟，踵，后跟
height	n.高，高度；高处
heir	n.后嗣，继承人
helicopter	n.直升机
hell	n.地狱；极大的痛苦
hello	int.喂
helmet	n.头盔，钢盔
help	vt.帮助；援助
helpful	a.给予帮助的；有用的
helpless	a.无助的；无能的
hen	n.母鸡，雌禽
hence	ad.因此，所以；今后
her	pron.(宾格)她；她的
herd	n.兽群，牧群
here	ad.这里；向这里
hero	n.男主角；英雄；勇士
heroic	a.英雄的；英勇的
heroine	n.女主角；女英雄
hers	pron.她的(所有物)
herself	pron.她自己；她亲自
hesitate	vi.犹豫，踌躇；含糊
hi	ini.嗨(表示问候等)
hide	vt.把…藏起来；隐瞒
high	a.高的；高级的
highly	ad.高度地，很，非常
highway	n.公路；大路
hill	n.小山，山岗；丘陵
hillside	n.(小山)山腰，山坡
him	pron.(宾格)他
himself	pron.他自己；他亲自
hint	n.暗示，示意；建议
hire	vt.租借
his	pron.他的，他的东西
historical	a.历史的，有关历史的
history	n.历史；个人经历
hit	vt.打；碰撞
hobby	n.业余爱好，癖好
hold	vt.拿住；掌握；拥有
hole	n.洞；孔眼，裂开处
holiday	n.假日，节日；假期
hollow	a.空的；空洞的
holy	a.神圣的；圣洁的
home	n.家；家乡
honest	a.诚实的；可敬的
honesty	n.诚实，正直
honey	n.蜜，蜂蜜；甜，甜蜜
honeymoon	n.蜜月
honour	n.光荣；尊敬，敬意
honourable	a.诚实的；光荣的
hook	n.钩，挂钩
hope	n.&vt.&vi.希望
hopeful	a.有希望的
hopeless	a.没有希望的，绝望的
horizon	n.地平线；眼界，见识
horizontal	a.地平的；水平的
horn	n.号角；警报器；角
horror	n.恐怖；战栗；憎恶
horse	n.马；马科动物
horsepower	n.马力
hospital	n.医院
host	n.主人；东道主
hostess	n.女主人；空姐
hostile	a.敌方的；不友善的
hot	a.热的；刺激的；辣的
hotel	n.旅馆
hour	n.小时；时间，时刻
house	n.房屋，住宅；商号
household	n.家庭，户；家务
housewife	n.家庭主妇
how	ad.怎么；怎样；多少
however	ad.然而；不管怎样
huge	a.巨大的，庞大的
human	a.人的，人类的
humble	a.谦逊的；地位低下的
humid	a.湿的，湿气重的
humorous	a.富于幽默的，诙谐的
humour	n.幽默，诙谐，幽默感
hundred	num.百，百个
hunger	n.饿，饥饿；渴望
hungry	a.饥饿的；渴望的
hunt	n.打猎；搜寻
hurry	vi.赶紧
hurt	vt.使受伤；使痛心
husband	n.丈夫
hut	n.小屋，棚屋
hydrogen	n.氢
I	pron.(主格)我
ice	n.冰，冰块
ice-cream	n.冰淇淋
idea	n.想法；思想；意见
ideal	a.理想的；观念的
identical	a.完全相同的；同一的
identify	vt.认出，识别，鉴定
idiom	n.习语，成语
idle	a.空闲的；懒散的
i.e.	(=that
if	conj.假如，如果
ignorant	a.不知道的；无知的
ignore	vt.不顾，不理，忽视
ill	a.有病的；坏的
illegal	a.不合法的，非法的
illness	n.病，疾病
illustrate	vt.(用图等)说明
illustration	n.说明，图解；例证
image	n.像；形象；映象
imaginary	a.想象中的，假想的
imagination	n.想象；想象力；空想
imagine	vt.想象，设想；料想
imitate	vt.模仿，仿效；仿制
immediate	a.立即的；直接的
immediately	ad.立即；直接地
immense	a.巨大的；极好的
immigrant	n.移民
impact	n.影响，作用；冲击
impatient	a.不耐烦的，急躁的
implication	n.含义，暗示，暗指
imply	vt.暗示，意指
import	vt.&n.输入，进口
importance	n.重要；重要性
important	a.重要的；有势力的
impose	vt.把…强加；征(税)
impossible	a.不可能的，办不到的
impress	vt.给…深刻印象
impression	n.印；印象；印记
impressive	a.给人印象深刻的
imprison	vt.关押，监禁；限制
improve	vt.使更好
improvement	n.改进，改善；改进处
in	prep.在…里ad.进，入
inch	n.英寸
incident	n.发生的事；事件
incline	n.斜坡
include	vt.包括，包含
income	n.收入；收益；进款
incorrect	a.不正确的，错误的
increase	vt.&vi.&n.增加
increasingly	ad.日益，越来越多地
indeed	ad.真正地；确实
indefinite	a.不明确的；不定的
independence	n.独立，自主，自立
independent	a.独立的；自主的
index	n.索引；指数；指标
India	n.印度
Indian	a.印度的
indicate	vt.标示，表示；表明
indication	n.指示；表示；表明
indifferent	a.冷漠的；不积极的
indignant	a.愤慨的，义愤的
indirect	a.间接的；不坦率的
indispensable	a.必不可少的，必需的
individual	a.个别的；独特的
indoors	ad.在室内，在屋里
industrial	a.工业的；产业的
industrialize	vt.使工业化
industry	n.工业，产业；勤劳
inefficient	a.效率低的，无能的
inevitable	a.不可避免的，必然的
inexpensive	a.花费不多的，廉价的
infant	n.婴儿
infect	vt.传染；感染
infer	vt.推论，推断；猜想
inferior	a.下等的；劣等的
infinite	a.无限的；无数的
influence	n.影响；势力
influential	a.有影响的；有权势的
inform	vt.通知，向…报告
information	n.消息，信息；通知
inhabit	vt.居住于，栖息于
inhabitant	n.居民，住户
inherit	vt.继承(传统等)
initial	a.最初的；词首的
injection	n.注射，注入；充满
injure	vt.伤害，损害，损伤
injury	n.损害，伤害；受伤处
ink	n.墨水，油墨
inn	n.小旅店；小酒店
inner	a.内部的；内心的
innocent	a.清白的，幼稚的
input	n.输入；投入的资金
inquire	vt.打听，询问；调查
inquiry	n.询问，打听；调查
insect	n.昆虫，虫
insert	vt.插入;
inside	prep.在…里面
insist	vi.坚持；坚持要求
inspect	vt.检查，审查；检阅
inspection	n.检查，审查；检阅
inspire	vt.鼓舞；给…以灵感
install	vt.安装，设置
installation	n.安装；装置；设施
instance	n.例子，实例，事例
instant	n.瞬间
instantly	ad.立即，即刻
instead	ad.代替，顶替；反而
instinct	n.本能；直觉；生性
institute	n.研究所；学院
institution	n.协会；制度，习俗
instruct	vt.教；指示；通知
instruction	n.命令；教学；教训
instrument	n.仪器；工具；乐器
insufficient	a.不足的；不适当的
insult	vt.&n.侮辱，凌辱
insurance	n.保险；保险费
insure	vt.给…保险；确保
intellectual	n.知识分子
intelligence	n.智力；理解力；情报
intelligent	a.聪明的；理智的
intend	vt.想要，打算；意指
intense	a.强烈的；紧张的
intensity	n.强烈，剧烈；强度
intensive	a.加强的；精耕细作的
intention	n.意图，意向，目的
intentional	a.故意的，有意识的
interaction	n.相互作用；干扰
interest	n.兴趣；利益；利息
interesting	a.有趣的，引人入胜的
interfere	vi.干涉，干预；妨碍
interference	n.干涉，干预；阻碍
interior	a.内的；内地的n.内部
intermediate	a.中间的；中级的
internal	a.内的；国内的
international	a.国际的，世界(性)的
interpret	vt.解释，说明；口译
interpretation	n.解释；口译
interpreter	n.译员，口译者
interrupt	vt.打断，打扰；中止
interruption	n.中断，打断；障碍物
interval	n.间隔；休息；间距
interview	n.接见；会见；面谈
intimate	a.亲密的；个人的
into	prep.进，入；进入到
introduce	vt.介绍；引进，传入
introduction	n.介绍；引进；引言
invade	vt.入侵，侵略；侵袭
invasion	n.入侵，侵略；侵犯
invent	vt.发明，创造；捏造
invention	n.发明，创造；捏造
inventor	n.发明者；发明家
invest	vt.投资；投入
investigate	vt.&vi.调查
investigation	n.调查，调查研究
investment	n.投资，投资额，投入
invisible	a.看不见的，无形的
invitation	n.邀请，招待；请柬
invite	vt.邀请，聘请；招待
involve	vt.使卷入；牵涉
inward	a.里面的
iron	n.铁；烙铁
irregular	a.不规则的；不整齐的
island	n.岛，岛屿
isolate	vt.使隔离，使孤立
issue	n.问题；发行
it	pron.这，那，它
Italian	a.意大利的n.意大利人
item	n.条，条款；一条
its	pron.它的
itself	pron.它自己；自身
jacket	n.短上衣，茄克衫
jail	n.监狱
jam	n.果酱
jam	vt.使塞满；使堵塞
January	n.一月
Japan	n.日本，日本国
Japanese	a.日本的
jar	n.罐子，坛子，广口瓶
jaw	n.颌，颚
jazz	n.爵士音乐，爵士舞曲
jealous	a.妒忌的；猜疑的
jet	n.喷气式飞机；喷嘴
jewel	n.宝石；宝石饰物
jewish	a.犹太人的
job	n.职业；工作；零活
join	vt.参加；连接
joint	n.接头，接缝；关节
joke	n.笑话
jolly	a.快活的；令人高兴的
journal	n.日报，杂志；日志
journalist	n.记者，新闻工作者
journey	n.旅行，旅程
joy	n.欢乐，喜悦；乐事
joyful	a.十分喜悦的，快乐的
judge	n.法官；裁判员
judgement	n.意见；审判；判断
juice	n.(水果等)汁，液
July	n.七月
jump	vi.跳；暴涨
June	n.六月
jungle	n.丛林，密林，莽丛
junior	a.年少的
jury	n.陪审团；评奖团
just	ad.刚才；只是；正好
justice	n.正义，公正；司法
justify	vt.证明…是正当的
keen	a.热心的；激烈的
keep	vi.保持；坚持
keeper	n.看护人；饲养员
kettle	n.水壶，水锅
key	n.钥匙；键；答案
keyboard	n.键盘
kick	vi.&vt.&n.踢
kid	n.小孩，儿童，少年
kill	vi.杀死；扼杀；消磨
kilogram	n.千克，公斤
kilometer	n.千米，公里
kind	n.种类
kind	a.友好的；和蔼的
kindness	n.仁慈，好意
king	n.国王，君主
kingdom	n.王国；领域，界
kiss	vt.吻
kitchen	n.厨房，灶间
kite	n.风筝
knee	n.膝，膝盖，膝关节
kneel	vi.跪，跪下，跪着
knife	n.小刀，刀，餐刀
knit	vt.把…编结
knob	n.门把，拉手；旋纽
knock	vi.&vt.&n.敲，击，打
knot	n.(绳的)结，(树的)节
know	vt.知道；认识；通晓
knowledge	n.知识，学识；知道
lab	n.实验室，研究室
label	n.标签；标记，符号
laboratory	n.实验室，研究室
labour	n.劳动；工作；劳工
lace	n.鞋带，系带；花边
lack	vi.&vi.&n.缺乏，不足
ladder	n.梯子，梯状物
lady	n.女士，夫人；贵妇人
lag	vi.走得慢
lake	n.湖
lamb	n.羔羊，小羊；羔羊肉
lame	a.跛的；瘸的，残废的
lamp	n.灯
land	n.陆地；土地
landing	n.上岸，登陆，着陆
landlady	n.女房东；女地主
landlord	n.地主；房东，店主
lane	n.(乡间)小路；跑道
language	n.语言，语言课程
lantern	n.提灯，灯笼
lap	n.膝部；一圈
large	a.大的；巨大的
largely	ad.大部分；大量地
laser	n.激光
last	a.最后的
last	vi.持续，持久；耐久
late	a.迟的
lately	ad.最近，不久前
later	ad.后来；过一会儿
Latin	a.拉丁的
latter	a.(两者中)后者的
laugh	vi.笑，发笑
laughter	n.笑，笑声
launch	vt.发射，投射；发动
laundry	n.洗衣房，洗衣店
lavatory	n.盥洗室，厕所
law	n.法律，法令；法则
lawn	n.草地，草坪，草场
lawyer	n.律师；法学家
lay	vt.置放；铺设；设置
layer	n.层，层次；铺设者
layout	n.布局，安排，设计
lazy	a.懒惰的，懒散的
lead	vt.为…带路；领导
lead	n.铅，铅制品
leader	n.领袖，领导人；首领
leadership	n.领导
leading	a.指导的；最主要的
leaf	n.叶，叶子
league	n.同盟，联盟；联合会
leak	vi.漏；泄露
lean	vi.倾斜，屈身；*
leap	vi.跳，跃
learn	vi.&vt.学，学习
learned	a.有学问的；学术上的
learning	n.学习；学问，知识
least	a.最少的
leather	n.皮革；皮革制品
leave	vi.离去
lecture	n.&vi.演讲，讲课
left	a.左边的
leg	n.腿，腿部
legal	a.法律的；合法的
legend	n.传说，传奇
leisure	n.空闲时间；悠闲
lemon	n.柠檬，柠檬树
lend	vt.把…借给，贷(款)
length	n.长，长度；一段
lens	n.透镜，镜片；镜头
less	a.更少的
lessen	vt.减少，减轻；缩小
lesson	n.功课，课；课程
lest	conj.惟恐，以免
let	vt.允许，让；使
letter	n.信；证书；字母
level	n.水平面
lever	n.杆，杠杆；控制杆
liable	a.易于…的；可能的
liar	n.说谎的人
liberal	a.心胸宽大的；慷慨的
liberate	vt.解放；释放
liberation	n.解放
liberty	n.自由；释放；许可
librarian	n.图书馆馆长
library	n.图书馆；藏书
license	n.许可；执照
lick	vt.舔；舔吃
lid	n.盖子，盖，囊盖
lie	vi.躺，平放；位于
lie	vi.说谎，欺骗
lieutenant	n.陆军中尉；副职官员
life	n.生命；一生；寿命
lifetime	n.一生，终身
lift	vt.提起，提高
light	n.光，光线；灯，光源
light	a.轻的，少量的
lighten	vt.照亮，使明亮
lightly	ad.轻轻地，轻松地
lightning	n.闪电，闪电放电
like	vt.喜欢；喜爱；希望
like	prep.像，如；像要
likely	a.可能的
likewise	ad.同样地；也，又
limb	n.肢，臂，翼；树枝
lime	n.石灰
limit	n.限度；限制；范围
limitation	n.限制；限度，局限
limited	a.有限的
line	n.线；排；路线；线条
linen	n.亚麻布；亚麻织物
liner	n.班船，班机
link	vt.有环连接
lion	n.狮子；勇猛的人
lip	n.嘴唇
liquid	n.液体
liquor	n.酒；溶液，液剂
list	n.表，目录
listen	vi.听，留神听；听从
listener	n.听者，听众之一
liter	n.升(容量单位)
literary	a.文学(上)的
literature	n.文学；文献
little	a.小的；少；幼小的
live	vi.居住；活
lively	a.活泼的；逼真的
liver	n.肝；肝脏
living	a.活的
living-room	n.起居室
load	vt.装；装满
loaf	n.一条面包，一个面包
loan	n.贷款；暂借
local	a.地方的；局部的
locate	vt.探明，找出，查出
location	n.位置，场所
lock	n.锁
locomotive	n.火车头，机车
lodge	vi.暂住，借宿，投宿
log	n.原木，木料
logic	n.逻辑，推理；逻辑性
logical	a.逻辑的；符合逻辑的
lonely	a.孤独的；荒凉的
long	a.长的；远的
long	vi.渴望，极想念
look	vi.看，显得
loop	n.圈，环，环孔
loose	a.松的；宽松的
loosen	vt.解开；使松驰
lord	n.贵族；上帝，基督
lorry	n.运货汽车，卡车
lose	vt.失去；迷失；输掉
loss	n.遗失；损失；失败
lot	n.许多，大量；签，阄
loud	a.响亮的；吵闹的
loudspeaker	n.扬声器，喇叭
love	vt.爱，喜欢
lovely	a.可爱的；令人愉快的
lover	n.爱好者；情人；情侣
low	a.低的，矮的；低下的
lower	a.较低的
loyal	a.忠诚的，忠心的
loyalty	n.忠诚，忠心
luck	n.运气；好运，幸运
lucky	a.幸运的；吉祥的
luggage	n.行李；皮箱，皮包
lumber	n.木材；木料；制材
lump	n.团，块；肿块
lunch	n.午餐，(美)便餐
lung	n.肺脏，肺
luxury	n.奢侈，奢华；奢侈品
machine	n.机器；机械
mad	a.发疯的；恼火的
madam	n.夫人，女士，太太
magazine	n.杂志，期刊
magic	n.魔法，巫术；戏法
magnet	n.磁铁，磁石，磁体
magnetic	a.磁的，有吸引力的
magnificent	n.壮丽的；华丽的
maid	n.女佣，女仆；少女
mail	n.邮件
main	a.主要的，最重要的
mainly	ad.主要地，大体上
mainland	n.大陆
maintain	vt.维持；赡养；维修
maintenance	n.维持，保持；维修
major	a.较大的
majority	n.多数，大多数
make	vt.使；做，制造
male	a.男的，雄的
man	n.男人；人；人类
manage	vt.管理；设法；对付
management	n.管理；经营，处理
manager	n.经理，管理人
mankind	n.人类
manly	a.男子气概的，果断的
manner	n.方式；态度；礼貌
manual	a.体力的
manufacture	vt.制造
manufacturer	n.制造商；制造厂
many	a.许多的
map	n.地图；图；天体图
marble	n.大理石
March	n.三月
march	vi.行军；游行示威
margin	n.页边的空白；边缘
marine	a.海的；海上的
mark	n.斑点；记号
market	n.市场；集市；销路
marriage	n.结婚，婚姻；婚礼
married	a.已婚的；婚姻的
marry	vt.娶，嫁
marvelous	a.奇迹般的；了不起的
Marxisim	n.马克思主义
Marxist	a.马克思主义的
mask	n.面具；伪装
mass	n.众多；团；群众
master	n.主人；能手；硕士
masterpiece	n.杰作，名著
mat	n.席子；草席；垫子
match	n.比赛，竞赛；对手
match	n.(一根)火柴
mate	n.伙伴，同事；配偶
material	n.材料；素材a.物质的
materialism	n.唯物主义
mathematical	a.数学的，数学上的
mathematics	n.数学
maths	n.(英)数学
matter	n.事情；物质
mature	a.成熟的
maximum	n.最大量
May	n.五月
may	v.aux.可能；可以，祝
maybe	ad.大概，或许；也许
mayor	n.市长
me	pron.(宾格)我
meadow	n.草地，牧草地
meal	n.膳食，一餐
mean	vt.作…解释；意指
mean	a.自私的；吝啬的
mean	a.平均的
meaning	n.意义，意思；意图
means	n.方法，手段，工具
meantime	n.其时，其间
meanwhile	ad.同时，当时
measurable	a.可测量的
measure	vt.量，测量
measurement	n.衡量，测量；尺寸
meat	n.肉
mechanic	n.技工，机械，机修工
mechanical	a.机械的；力学的
mechanically	ad.机械地
mechanics	n.力学；技术性细节
medal	n.奖章，勋章，纪念章
medical	a.医学的；内科的
medicine	n.内服药；医学
Mediterranean	n.地中海
medium	n.媒质；中间a.中等的
meet	vt.遇见
meeting	n.聚集，会合，会见
melon	n.瓜，甜瓜
melt	vi.融化
member	n.成员，会员
memorial	a.纪念的；记忆的
memory	n.记忆；回忆；存储
mend	vt.修理，修补，缝补
mental	a.智力的；精神的
mention	vt.&n.提及，说起
menu	n.菜单；饭菜，菜肴
merchant	n.商人；零售商
mercury	n.水银，汞
Mercury	n.水星
mercy	n.仁慈，慈悲，恩惠
mere	a.仅仅的；纯粹的
merely	ad.仅仅，只不过
merit	n.长处，优点；功过
merry	a.欢乐的，愉快的
mess	n.混乱，混杂，肮脏
message	n.信息，消息；启示
messenger	n.送信者，信使
metal	n.金属，金属制品
meter	n.计量器，计，表
method	n.方法，办法；教学法
metre	n.米，公尺
metric	a.公制的，米制的
microcomputer	n.微型计算机，微机
microphone	n.话筒，麦克风
microscope	n.显微镜
midday	n.正午，中午
middle	n.中部
midnight	n.午夜，子夜，夜半
midst	n.中部，中间，当中
might	v.aux.可能，会，也许
might	n.力量，威力，能力
mild	a.和缓的；温柔的
mile	n.英里
military	a.军事的；军人的
milk	n.乳，牛奶
mill	n.磨坊；制造厂
millimetre	n.毫米
million	num.百万
mind	n.头脑；理智；记忆
mine	pron.我的
mine	n.矿，矿山；地雷
miner	n.矿工
mineral	n.矿物
minimum	n.最小量
minister	n.部长，大臣；公使
ministry	n.(政府的)部
minor	a.较小的；较次要的
minority	n.少数；少数民族
minus	a.负的
minute	n.分，分钟；一会儿
minute	a.微细的；详细的
miracle	n.奇迹，令人惊奇的人
mirror	n.镜子
miserable	a.痛苦的，悲惨的
mislead	vt.使误入岐途
miss	n.小姐
miss	vt.未看到；惦念
missile	n.发射物；导弹
missing	a.缺掉的，失去的
mission	n.使命，任务；使团
mist	n.薄雾
mistake	n.错误
Mister	n.先生
mistress	n.女主人；夫人
misunderstand	vt.误解，误会，曲解
mix	vt.使混合，混淆
mixture	n.混合；混合物
moan	n.呻吟声
mobile	a.运动的；流动的
mode	n.方式，样式
model	n.模型；模式；模特儿
moderate	a.温和的；有节制的
modern	a.现代的，近代的
modest	a.有节制的；谦虚的
modify	vt.更改，修改；修饰
moist	a.湿润的；多雨的
moisture	n.潮湿，湿气；温度
molecule	n.分子，克分子
moment	n.片刻，瞬间，时刻
Monday	n.星期一
money	n.货币；金钱，财富
monitor	n.班长；监视器
monkey	n.猴子，猿
month	n.月，月份
monthly	a.每月的
monument	n.纪念碑；纪念馆
mood	n.心情，情绪；语气
moon	n.月球，月亮；卫星
moral	a.道德的；合乎道德的
more	a.更多的
moreover	ad.再者，加之，此外
morning	n.早晨，上午
mortal	a.终有一死的；致死的
mosquito	n.蚊子
most	a.最多的
mostly	ad.主要的，大部分
mother	n.母亲，妈妈
motion	n.运动；手势；提议
motivate	vt.促动；激励，激发
motive	n.动机，目的
motor	n.发动机；机动车
mould	n.模子，模型
mount	vt.登上，爬上
mountain	n.山，山岳；山脉
mourn	vi.哀痛，哀悼
mouse	n.鼠，耗子
mouth	n.嘴，口，口腔
mouthful	n.满口，一口，少量
move	vt.移动；感动
movement	n.动作，活动；移动
movie	n.电影；电影院
much	ad.非常，很
mud	n.软泥，泥浆
muddy	a.多泥的，泥泞的
mug	n.大杯
multiple	a.复合的；并联的
multiply	vt.使增加；乘
murder	n.&vi.谋杀，凶杀
murderer	n.杀人犯，凶手
muscle	n.肌肉，肌；体力
museum	n.博物馆；展览馆
mushroom	n.蘑菇，菌类植物
music	n.音乐，乐曲，乐谱
musical	a.音乐的；和谐的
musician	n.音乐家；作曲家
must	v.aux.必须；必然要
mute	a.缄默的
mutter	vi.轻声低语；抱怨
mutton	n.羊肉
mutual	a.相互的；共同的
my	pron.我的
myself	pron.我自己；我亲自
mysterious	a.神秘的；难以理解的
mystery	n.神秘；神秘的事物
nail	n.钉；指甲
naked	a.裸体的；无遮敝的
name	n.名字；名誉
namely	ad.即，也就是
nap	n.小睡，打盹，瞌睡
narrow	a.狭的，狭窄的
nasty	a.龌龊的；淫猥的
nation	n.民族；国家
national	a.民族的；国家的
nationality	n.国籍；民族，族
native	a.本土的
natural	a.自然界的；天然的
naturally	ad.自然地；天然地
nature	n.大自然；本性；性质
naughty	a.顽皮的，淘气的
naval	n.海军的，军舰的
navigation	n.航行；航海术；导航
navy	n.海军
near	ad.近，接近
nearby	a.附近的
nearly	ad.差不多；密切地
neat	a.整洁的；熟练的
necessarily	ad.必然，必定
necessary	a.必要的；必然的
necessity	n.必要性；必然性
neck	n.颈，脖子
necklace	n.项链，项圈
need	vt.需要
needle	n.针，缝补，编织针
needless	a.不需要的
negative	a.否定的；消极的
neglect	vt.忽视，忽略；疏忽
Negro	n.黑人
neighbour	n.邻居，邻国，邻人
neighbourhood	n.邻居关系；邻近
neither	a.(两者)都不的
nephew	n.侄子，外甥
nerve	n.神经；勇敢，胆量
nervous	a.神经的；易激动的
nest	n.巢，窝，穴
net	n.网，网状物；通信网
network	n.网状物；网络
neutral	a.中立的；中性的
never	ad.永不，决不；不
nevertheless	conj.然而
new	a.新的；新近出现的
newly	ad.新近，最近
news	n.新闻，消息
newspaper	n.报纸，报
next	a.紧接的；贴近的
nice	a.美好的，令人愉快的
niece	n.侄女，外甥女
night	n.夜，夜间
nine	num.九，九个
nineteen	num.十九，十九个
ninety	num.九十，九十个
ninth	num.第九；九分之一
nitrogen	n.氮
no	ad.不；并不
noble	a.贵族的；高尚的
nobody	pron.谁也不；无人
nod	vt.点(头)；点头表示
noise	n.喧闹声；响声；噪声
noisy	a.嘈杂的；喧闹的
none	pron.没有人
nonsense	n.胡说，废话
noon	n.正午，中午
nor	conj.也不；不
normal	a.正常的，普通的
normally	ad.通常，正常地
north	n.北，北方
northeast	n.东北
northern	a.北方的，北部的
northwest	n.西北
nose	n.鼻子；突出部分
not	ad.不，没有
note	n.笔记；便条；注释
notebook	n.笔记本，期票簿
nothing	n.没有东西
notice	vt.注意
noticeable	a.显而易见的；重要的
noun	n.名词
novel	n.小说
November	n.十一月
now	ad.现在；立刻；于是
nowadays	ad.现今，现在
nowhere	ad.任何地方都不
nuclear	a.原子核的；核心的
nucleus	n.核，核心；(原子)核
nuisance	n.讨厌的东西
number	n.数，数字；号码
numerous	a.为数众多的；许多
nurse	n.保姆；护士
nursery	n.托儿所；苗圃
nut	n.坚果，干果；螺母
nylon	n.尼龙，耐纶
oak	n.栎属植物；栎木
oar	n.浆，橹
obey	vt.顺从
object	n.物，物体；目的
object	vi.反对；抱反感
objection	n.反对，异议；不喜欢
objective	a.客观的；无偏见的
oblige	vt.迫使；施恩惠于
observation	n.注意；观察；观察力
observe	vt.遵守；看到；说
observer	n.观察员，观测者
obstacle	n.障碍，障碍物，妨害
obtain	vt.获得，得到，买到
obvious	a.明显的，显而易见的
obviously	ad.明显地，显然地
occasion	n.场合，时刻；时机
occasional	a.偶然的；临时的
occasionally	ad.偶然；非经常地
occupation	n.占领，占据；职业
occupy	vt.占领；占，占有
occur	vi.发生；出现，存在
occurrence	n.发生，出现；事件
ocean	n.海洋；洋
Oceania	n.大洋洲
o'clock	ad.…点钟
October	n.十月
odd	a.奇数的；单只的
odour	n.气味，香气；味道
of	prep.…的；由于
off	ad.(离)开；(停)止
offend	vt.冒犯
offer	vt.提供；提出
office	n.办公室；处，局，社
officer	n.官员；干事；军官
official	a.官员的；官方的
often	ad.经常，常常
oh	int.嗬，哦，唉呀
oil	n.油；石油
okay	(缩作OK)a.&ad.对，好
old	a.老的；…岁的
omit	vt.省略，省去；遗漏
on	prep.在…上；在…旁
once	ad.一次；曾经
one	num.一
oneself	pron.自己；亲自
onion	n.洋葱，洋葱头
only	ad.只，仅仅
onto	prep.到…上
open	a.开的；开放的
opening	a.开始的
opera	n.歌剧
operate	vi.操作；施行手术
operation	n.操作；手术；运算
operational	a.操作上的；可使用的
operator	n.操作人员，接线员
opinion	n.意见，看法，主张
opponent	n.对手，敌手；对抗者
opportunity	n.机会，良机
oppose	vt.反对；反抗
opposite	a.对面的
oppress	vt.压迫，压制；压抑
optical	a.眼的；光学的
optimistic	a.乐观的；乐观主义的
option	n.选择，选择权
optional	a.可以任意选择的
or	conj.或，或者；即
oral	a.口头的；口的
orange	n.橙(树)；柑(树)
orbit	n.运行轨道
orchestra	n.管弦乐队
order	n.次序；整齐
orderly	a.整洁的；有秩序的
ordinary	a.平常的；平凡的
ore	n.矿，矿石，矿砂
organ	n.器官；机构；管风琴
organic	a.有机体的；器官的
organism	n.生物体；有机体
organization	n.组织；团体，机构
organize	vt.组织，编组
oriental	a.东方的；东方国家的
origin	n.起源，由来；出身
original	a.最初的；新颖的
ornament	n.装饰物；装饰
orphan	n.孤儿
other	a.另外的；其余的
otherwise	ad.另外；要不然
ought	v.aux.应当，应该
ounce	n.盎司，英两
our	pron.我们的
ours	pron.我们的
ourselves	pron.我们自己
out	ad.出，在外；现出来
outcome	n.结果，后果，成果
outdoor	a.户外的，室外的
outdoors	ad.在户外，在野外
outer	a.外部的，外面的
outlet	n.出口，出路；排遣
outline	n.轮廓；略图；大纲
outlook	n.观点，看法；展望
output	n.产量；输出量；输出
outset	n.开始，开端
outside	n.外部；外表a.外部的
outskirt	n.外边，郊区
outstanding	a.突出的，杰出的
outward	a.外面的；向外的
outwards	ad.向外，往海外
oven	n.炉，灶；烘箱
over	prep.在…上方；超过
overall	n.工装裤
overcoat	n.外衣，大衣
overcome	vt.战胜，克服
overhead	a.在头顶上的；架空的
overlook	vt.眺望；看漏；放任
overnight	ad.一夜；突然
overseas	ad.海外
overtake	vt.追上，赶上；压倒
overtime	a.超时的，加班的
owe	vt.欠；应把…归功于
owl	n.猫头鹰，枭
own	a.自己的
owner	n.物主，所有人
ownership	n.所有(权)，所有制
ox	n.牛；公牛，阉牛
phase	n.阶段；方面；相位
phenomenon	n.现象
philosopher	n.哲学家
philosophy	n.哲学；哲理；人生观
phone	n.电话，电话机；耳机
photograph	n.照片，相片
photographic	a.摄影的，摄影用的
phrase	n.短语；习惯用语
physical	a.物质的；物理的
physician	n.医生，内科医生
physicist	n.物理学家
physics	n.物理学
piano	n.钢琴
pick	n.镐，鹤嘴锄
pick	vt.拾，摘
picnic	n.郊游，野餐
picture	n.画，图片
pie	n.(西点)馅饼
piece	n.碎片，块
pierce	vt.剌穿
pig	n.猪，小猪，野猪
pigeon	n.鸽子
pile	n.堆
pill	n.药丸，丸剂
pillar	n.柱，柱子；栋梁
pillow	n.枕头
pilot	n.领航员；飞行员
pin	n.针，饰针
pinch	vt.捏，拧，掐掉
pine	n.松树，松木
pink	n.粉红色
pint	n.品脱
pioneer	n.拓荒者；先驱者
pipe	n.管子，导管；烟斗
pipeline	n.管道，管线
pistol	n.手枪
pit	n.坑，地坑；煤矿
pitch	n.沥青
pitch	vt.投，掷
pity	n.怜悯；遗憾
place	n.地方，地点；住所
plain	n.平原
plan	n.&vt.计划，打算
plane	n.平面；飞机
planet	n.行星
plant	n.植物；工厂
plantation	n.种植园；栽植
plaster	n.灰泥；硬膏；熟石膏
plastic	a.可塑的
plate	n.板，片，盘
platform	n.平台；站台；讲台
play	vi.玩，游戏；演奏
player	n.游戏的人；比赛者
playground	n.操场，运动场
pleasant	a.令人愉快的，舒适的
please	vt.使高兴，请vi.满意
pleasure	n.愉快，快乐；乐事
plentiful	a.丰富的，富裕的
plenty	n.丰富，充足，大量
plot	n.小块土地
plough	n.犁
pluck	vt.采，摘；拉下
plug	n.塞子；插头
plunge	vt.使投入；使陷入
plural	a.复数的
plus	prep.加，加上
P.M.	n.下午，午后
pocket	n.衣袋
poem	n.诗，韵文，诗体文
poet	n.诗人
poetry	n.诗，诗歌，诗作
point	n.点；要点；细目；分
poison	n.毒，毒药
poisonous	a.有毒的，有害的
pole	n.杆，柱
pole	n.极(点)，磁极，电极
police	n.警察；警察当局
policeman	n.警察
policy	n.政策，方针
polish	vt.磨光；使优美
polite	a.有礼貌的；有教养的
political	a.政治的，政治上的
politician	n.政治家；政客
politics	n.政治，政治学；政纲
pollute	vt.弄脏，污染，沾污
pollution	n.污染
pond	n.池塘
pool	n.水塘，游泳池，水池
pool	n.共用物
poor	a.贫穷的；贫乏的
pop	n.流行音乐，流行歌曲
pop	n.砰的一声，爆破声
popular	a.民众的；流行的
population	n.人口；全体居民
porch	n.门廊，入口处
pork	n.猪肉
porridge	n.粥，麦片粥
port	n.港，港口
portable	a.轻便的；手提的
porter	n.搬运工人
portion	n.一部分；一分
portrait	n.消像，画像
Portuguese	n.葡萄牙人；葡萄牙语
position	n.位置；职位；姿势
positive	a.确定的；积极的
possess	vt.占用，拥有(财产)
possession	n.有，所有；占有物
possibility	n.可能；可能的事
possible	a.可能的；可能存在的
possibly	ad.可能地；也许
post	n.柱，桩，杆
post	n.邮政，邮寄；邮件
post	n.岗位，哨所；职位
postage	n.邮费，邮资
postman	n.邮递员
postpone	vt.延迟，推迟，延缓
pot	n.锅，壶，罐，盆
potato	n.马铃薯，土豆
potential	a.潜在的
pound	n.磅；英磅
pound	vt.捣碎；舂烂；猛击
pour	vt.灌，倒
poverty	n.贫穷，贫困
powder	n.粉末；药粉；火药
power	n.能力；力；权；幂
powerful	a.强有力的；有权威的
practical	a.实践的；实用的
practically	ad.实际上；几乎
practice	n.实践；练习；业务
practise	vt.练习，实习，训练
praise	n.赞扬，赞美
pray	vt.&vi.请求；祈祷
prayer	n.祈祷，祈求
precaution	n.预防；警惕
preceding	a.在前的；在先的
precious	a.珍贵的，宝贵的
precise	a.精确的，准确的
precision	n.精确，精密，精密度
predict	v.预言，预告，预测
preface	n.序言，前言，引语
prefer	vt.宁可，宁愿
preferable	a.更可取的，更好的
preference	n.偏爱，优先；优先权
prejudice	n.偏见，成见
preliminary	a.预备的，初步的
premier	n.总理，首相
preparation	n.准备，预备；制备
prepare	vt.&vi.准备，预备
preposition	n.前置词，介词
prescribe	vt.命令；处(方)
presence	n.出席，到场；在
present	a.现在的
present	vt.赠送;
present	n.礼物，赠送物
presently	ad.一会儿；目前
preserve	vt.保护；保存；腌渍
president	n.总统；校长；会长
press	vt.压，按，揿；催促
pressure	n.压力；压力；压，按
pretend	vt.假托，借口vi.假装
pretty	a.漂亮的，标致的
prevail	vi.胜，优胜；流行
prevent	vt.预防，防止；阻止
previous	a.先的；前的
previously	ad.先前，预先
price	n.价格，价钱；代价
pride	n.骄傲；自豪
priest	n.教士，牧师，神父
primarily	ad.首先；主要地
primary	a.最初的；基本的
prime	a.首要的
primitive	a.原始的；粗糙的
prince	n.王子，亲王
princess	n.公主，王妃
principal	a.主要的
principle	n.原则，原理；主义
print	vt.印刷
prior	a.在先的；优先的
prison	n.监狱，监禁
prisoner	n.囚犯
private	a.私人的；私下的
privilege	n.特权，优惠
prize	n.奖赏，奖金
probability	n.可能性；概率
probable	a.或有的；大概的
probably	ad.或许，大概
problem	n.问题；习题，问题
procedure	n.程序；手续；过程
proceed	vi.进行；继续进行
process	n.过程；工序
procession	n.队伍，行列
proclaim	vt.宣告，宣布；表明
produce	vt.生产；产生；展现
product	n.产品，产物；(乘)积
production	n.生产；产品；总产量
productive	a.生产的；丰饶的
profession	n.职业
professional	a.职业的
professor	n.教授
profit	n.益处；利润
program	n.节目单；大纲；程序
progress	n.前进，进展；进步
progressive	a.进步的；向前进的
prohibit	vt.禁止，阻止
project	n.方案，工程
prominent	a.实起的；突出的
promise	n.诺言；指望
promising	a.有希望的；有前途的
promote	vt.促进，发扬；提升
prompt	a.及时的
pronoun	n.代名词
pronounce	vt.发…的音；宣布
pronunciation	n.发音，发音法
proof	n.证据；证明；校样
proper	a.适合的；合乎体统的
properly	ad.适当地；彻底地
property	n.财产，资产；性质
proportion	n.比，比率，部分
proportional	a.比例的；相称的
proposal	n.提议，建议；求婚
propose	vt.提议
prospect	n.展望；前景，前程
prosperity	n.繁荣；昌盛，兴旺
prosperous	a.繁荣的，昌盛的
protect	vt.保护，保卫，警戒
protection	n.保护，警戒
protective	a.保护的，防护的
protein	n.蛋白质，朊
protest	vt.&vi.&n.抗议
proud	a.骄傲的；自豪的
prove	vt.证明
provide	vt.提供；装备，供给
provided	conj.以…为条件
province	n.省；领域，部门
provision	n.供应；预备；存粮
psychological	a.心理的，心理学的
public	a.公众的
publication	n.公布；出版；出版物
publish	vt.公布；发表；出版
pudding	n.布丁
puff	n.(一)喷，(一)吹
pull	vt.拉，拖；拉，拉力
pulse	n.脉搏；脉冲，脉动
pump	n.泵
punch	vt.冲出
punch	vt.用拳猛击
punctual	a.严守时刻的；准时的
punish	vt.罚，惩罚，处罚
punishment	n.罚，惩罚，处罚
pupil	n.学生，小学生
pupil	n.瞳孔
puppet	n.木偶，玩偶；傀儡
purchase	n.买，购买
pure	a.纯粹的；纯洁的
purely	ad.纯粹地，完全地
purify	vt.使纯净，使洁净
purity	n.纯净；纯洁；纯度
purple	n.紫色
purpose	n.目的；意图；效果
purse	n.钱包，小钱袋，手袋
pursue	vt.追赶，追踪；进行
pursuit	n.追赶；追求；事务
push	vt.推，逼迫
put	vt.放，摆；使处于
puzzle	n.难题；谜
qualify	vt.使具有资格
quality	n.质量；品质，特性
quantity	n.量，数量，分量
quarrel	n.争吵，吵架，口角
quart	n.夸脱(=2品脱)
quarter	n.四分之一；一刻钟
quarterly	a.季度的
queen	n.王后；女王
queer	a.奇怪的，古怪的
question	n.发问；问题；疑问
queue	n.行列
quick	a.快的；敏捷的
quicken	vt.加快
quickly	ad.快，迅速
quiet	a.寂静的；安静的
quilt	n.被(子)
quit	vt.离开，退出；停止
quite	ad.完全；相当；的确
quiz	n.小型考试，测验
quotation	n.引用；引文；报价单
quote	vt.引用，引证；报价
rabbit	n.兔子，野兔
race	n.比赛，竞赛，竞争
race	n.人种，种族，民族
racial	a.种族的，人种的
rack	n.搁物架；行李架
rack	vt.使苦痛，折磨
racket	n.球拍
radar	n.雷达，无线电探测器
radiate	vi.发射光线；辐射
radiation	n.放射，发射；辐射能
radio	n.无线电；收音机
radioactive	a.放射性的
radioactivity	n.放射性，放射(现象)
radish	n.小萝卜
radium	n.镭
radius	n.半径
rag	n.破布，碎布，抹布
rage	n.(一阵)狂怒，盛怒
raid	n.袭击；突然搜查
rail	n.横条，横杆；铁轨
railroad	n.铁路
railway	n.铁路，铁道
rain	n.雨，雨水
rainbow	n.虹，彩虹
rainy	a.下雨的，多雨的
raise	vt.举起；引起；提高
rake	n.耙子
range	n.排，行；山脉；范围
rank	n.排，横行；社会阶层
rapid	a.快的
rapidly	ad.迅速地
rare	a.稀薄的；稀有的
rarely	ad.很少，难得
rat	n.老鼠，耗子
rate	n.比率；速度；价格
rather	ad.宁可，宁愿；相当
ratio	n.比，比率
rational	a.理性的；出于理性的
raw	a.未煮过的；未加工的
ray	n.光线，射线，辐射线
razor	n.剃刀
reach	vt.抵达；伸出vi.达到
react	vi.起反应；有影响
reaction	n.反应；反作用
read	vt.读，看懂
reader	n.读者；读物，读本
readily	ad.乐意地；无困难地
reading	n.读，阅读；读书
ready	a.准备好的；愿意的
real	a.真的；现实的
reality	n.现实；真实
realize	vt.实现；认识到
really	ad.真正地；实在
realm	n.王国，国土；领域
reap	vt.&vi.收割，收获
rear	n.后部，后面；背面
rear	vt.抚养，培养；栽种
reason	n.理由；理性
reasonable	a.合情合理的；公道的
rebel	vi.造反
rebellion	n.造反；叛乱；反抗
recall	vt.回想；叫回；收回
receipt	n.收到；收条，收据
receive	vt.收到；得到；接待
receiver	n.收受者，收件人
recent	a.新近的，最近的
recently	ad.最近，新近
reception	a.接待；招待会；接受
recite	vt.&vi.背诵，朗诵
recognition	n.认出，识别；承认
recognize	vt.认识，认出；承认
recollect	vt.回忆，追忆，想起
recommend	vt.推荐，介绍；劝告
recommendation	n.推荐，介绍；劝告
record	n.记录；履历
recorder	n.记录者；录音机
recover	vt.重新获得；挽回
recovery	n.重获；痊愈，恢复
red	a.红色的
reduce	vt.减少，减小；简化
reduction	n.减少，减小，缩减
reed	n.芦苇，芦杆，芦丛
reel	n.卷轴，卷筒
refer	vt.使求助于
reference	n.参考；出处；提及
refine	vt.&vi.精炼，提纯
reflect	vt.反射；反映；思考
reflection	n.反射；映象；反映
reflexion	n.反射；映象；反映
reform	vt.&n.改革，改良
refresh	vt.使清新vi.恢复精神
refreshment	n.茶点，点心，便餐
refrigerator	n.冰箱，冷藏库
refuge	n.避难，庇护；庇护者
refusal	n.拒绝
refuse	vt.拒绝
refute	vt.驳斥，反驳，驳倒
regard	vt.把…看作；尊敬
regarding	prep.关于
regardless	ad.不顾一切地
region	n.地区，地带；领域
register	n.&vt.登记，注册
regret	vt.懊悔；抱歉
regular	a.规则的；整齐的
regularly	ad.有规律地
regulate	vt.管理，控制；调整
regulation	n.规则，规章；管理
rehearsal	n.排练，排演；练习
reign	n.君主统治；支配
rein	n.缰绳
reinforce	vt.增援，支援；加强
reject	vt.拒绝；丢掉；驳回
rejoice	vi.欣喜，高兴
relate	vt.叙述；使联系
relation	n.关系，联系；家属
relationship	n.关系，联系
relative	a.有关系的；相对的
relatively	ad.相对地，比较地
relativity	n.相关性；相对性
relax	vt.使松弛
release	vt.释放；放松；发表
relevant	a.有关的，贴切的
reliability	n.可*性
reliable	a.可*的，可信赖的
reliance	n.信任，信赖，信心
relief	n.减轻；救济；援救
relieve	vt.减轻，解除；救济
religion	n.宗教；宗教信仰
religious	a.宗教的；虔诚的
reluctant	a.不愿的，勉强的
rely	vi.依赖，依*；信赖
remain	vi.剩下，余留；保持
remains	n.残余，余额；废墟
remark	vt.&vi.&n.评论，谈论
remarkable	a.异常的，非凡的
remedy	n.&vt.治疗；补救
remember	vt.记得，想起；记住
remind	vt.提醒，使想起
remote	a.相隔很远的；冷淡的
removal	n.移动；迁移；除掉
remove	vt.移动，搬开；脱掉
render	vt.表示，给予；使得
renew	vt.使更新
rent	n.租金，租
repair	vt.&n.修理，修补
repeat	vt.重说，重做
repeatedly	ad.重复地；一再
repent	vi.悔悟，悔改vt.后悔
repetition	n.重复，反复
replace	vt.把…放回；取代
reply	vi.&n.回答，答复
report	vt.&vi.报告；汇报
reporter	n.记者，通讯员
represent	vt.描绘；代表；象征
representative	a.代表性的
reproach	vt.&n.责备，指责
reproduce	vt.&vi.繁殖，生殖
republic	n.共和国，共和政体
republican	a.共和国的
reputation	n.名誉，名声；好名声
request	n.&v.请求，要求
require	vt.需要；要求，命令
requirement	n.需要；要求
rescue	vt.&n.援救，营救
research	n.&vi.调查，探究
researcher	n.调查者；探究者
resemble	vt.像，类似
reserve	vt.储备，保留；预定
reservior	n.水库；蓄水池
residence	n.居住；驻扎；住处
resident	a.居住的
resign	vt.放弃
resignation	n.放弃，辞职，反抗
resist	vt.&vi.抵抗，抵制
resistance	n.抵抗；抵制；抵抗力
resistant	a.抵抗的，反抗的
resolution	n.坚决，坚定；决定
resolve	vt.解决；决心
resort	vi.&n.求助，凭借
resource	n.资源，物力；办法
respect	n.&vt.尊敬，尊重
respectful	a.恭敬的，尊重的
respective	各自的，各个的
respectively	ad.各自地，分别地
respond	vi.作答；响应
response	n.作答，回答；响应
responsibility	n.责任，责任心；职责
responsible	a.有责任的；尽责的
rest	n.休息；安静；静止
rest	n.剩余部分；其余的人
restaurant	n.餐馆，饭店，菜馆
restless	a.不安定的，焦虑的
restore	vt.恢复；归还；修补
restrain	vt.抑制，遏制；限制
restraint	n.抑制；遏制；克制
restrict	vt限制，限定，约束
restriction	n.限制，限定，约束
result	n.成果
resume	vt.恢复；重新开始
retain	vt.保持，保留，保有
retell	vt.再讲，重述，复述
retire	vi.退下；引退；就寝
retreat	vi.(被迫)退却，后退
return	vi.&n.回来，返回
reveal	vt.展现；揭示，揭露
revenge	vt.替…报仇
reverse	vt.颠倒，翻转
review	vt.再检查
revise	vt.修订，校订；修改
revolt	vi.&n.反抗，造反
revolution	n.革命；旋转，绕转
revolutionary	a.革命的
reward	n.报答；报酬
rhythm	n.韵律，格律；节奏
rib	n.肋，肋骨
ribbon	n.缎带，丝带；带
rice	n.稻，米，饭
rich	a.富的，丰富的
rid	vt.使摆脱，使去掉
riddle	n.谜，谜语
ride	vi.&n.骑马，乘车
rider	n.骑马的人；乘车的人
ridge	n.脊；岭，山脉；垄
ridiculous	a.荒谬的，可笑的
rifle	n.步枪，来复枪
right	a.正确的
rigid	a.刚硬的；僵硬的
ring	n.环形物(如圈、环等)
ring	vi.鸣；按铃
ripe	a.熟的；时机成熟的
ripen	vt.使熟
rise	vi.起立；升起；上涨
risk	n.风险，危险，冒险
rival	n.竞争者
river	n.江，河，水道
road	n.路，道路，公路
roar	vi.吼叫；呼喊
roast	vt.&vi.烤，炙，烘
rob	vt.&vi.抢劫；劫掠
robber	n.强盗，盗贼
robbery	n.抢劫，劫掠，盗取
robe	n.长袍，长衣，浴衣
robot	n.机器人；自动机
rock	vt.摇，使动摇
rock	n.岩，岩石；石头
rocket	n.火箭，火箭发动机
rod	n.杆，竿，棒
role	n.角色，作用，任务
roll	vi.&vt.滚动；转动
roller	n.滚柱，滚筒，滚轴
Roman	n.古罗马人
romantic	a.浪漫的；传奇的
roof	n.屋顶，车顶；顶
room	n.房间；地位；余地
root	n.根，根子
rope	n.绳，索
rose	n.蔷薇花，蔷薇科植物
rot	vt.烂，腐坏
rotary	a.旋转的，转动的
rotate	vi.旋转
rotation	n.旋转，转动；循环
rotten	a.腐烂的，发臭的
rough	a.表面不平的；粗略的
roughly	ad.粗糙地，粗略地
round	a.圆的
rouse	vt.唤醒，唤起；惊起
route	n.路，路线，路程
routine	n.例行公事
row	n.(一)排，(一)行
row	vt.划(船等)
royal	a.王的；皇家的
rub	vt.摩擦，擦
rubber	n.橡皮(擦子)；橡胶
rubbish	n.垃圾，废物；废话
rude	a.加工粗糙的；粗野的
rug	n.小地毯；毛毯
ruin	n.毁灭；废墟
rule	n.统治；规定；习惯
ruler	n.统治者；尺，直尺
rumour	n.谣言，谣传，传闻
run	vi.跑，奔；行驶；流
runner	n.赛跑的人
rural	a.农村的，田园的
rush	vi.冲，奔
Russian	a.俄罗斯的
rust	n.锈
rusty	a.生锈的；变迟钝的
sack	n.袋，麻袋；开除
sacred	a.上帝的；神圣的
sacrifice	n.&vt.牺牲；南祭
sad	a.悲哀的，令人悲痛的
saddle	n.鞍子，马鞍
sadly	ad.悲痛地，悲哀地
sadness	n.悲痛，悲哀
safe	a.安全的；谨慎的
safe	n.保险箱
safely	ad.安全地；可*地
safety	n.安全，保险
sail	n.帆；船
sailor	n.水手，海员，水兵
saint	n.圣徒；基督教徒
sake	n.缘故，理由
salad	n.色拉；莴苣，生菜
salary	n.薪金，薪水
sale	n.卖；拍卖；销售额
salesman	n.售货员，推销员
salt	n.盐；盐类
salute	n.招呼，行礼
same	a.同一的，相同的
sample	n.样品；实例，标本
sand	n.沙，沙子；沙滩
sandwich	n.三明治
sandy	n.沙的，含沙的
satellite	n.卫星；人造卫星
satisfaction	n.满意；快事；赔偿
satisfactory	a.令人满意的，良好的
satisfy	vt.满足；使满意
Saturday	n.星期六
sauce	n.调味汁，酱汁
saucer	n.茶托，浅碟
sausage	n.香肠，腊肠
save	vt.救；节省；储蓄
saving	n.搭救；节约；存款
saw	n.锯子
say	vt.说；说明；比如说
scale	n.天平，磅秤，秤
scale	n.标度；比例；大小
scan	vt.细看；浏览；扫描
scar	n.伤疤，伤痕；创伤
scarce	a.缺乏的；希有的
scarcely	ad.仅仅；几乎不
scare	vt.惊吓
scarf	n.围巾，头巾；领带
scatter	vt.使消散；撒；散播
scene	n.发生地点；道具
scenery	n.舞台布景；风景
scent	n.气味，香味；香水
schedule	n.时间表；计划表
scheme	n.计划，规划；诡计
scholar	n.学者(尤指文学方面)
scholarship	n.学业成绩；奖学金
school	n.学校；学院；学派
science	n.科学，科学研究
scientific	a.科学(上)的
scientist	n.(自然)科学家
scissors	n.剪刀，剪子
scold	vi.责骂
scope	n.范围；余地，机会
score	n.得分，比数，成绩
scorn	n.轻蔑；嘲笑
scout	n.侦察员，侦察机
scrape	vt.&vi.&n.刮，擦
scratch	vt.&vi.&n.搔；抓
scream	vi.尖叫；呼啸
screen	n.屏；屏幕
screw	n.螺旋，螺丝
sea	n.海，海洋
seal	n.封蜡；印记
seal	n.海豹
seaman	n.海员，水手；水兵
seaport	n.海港，港市
search	vt.在…中搜寻，搜查
season	n.季，季节，时节
seat	n.座；座部
second	num.第二
second	n.秒
secondary	a.第二的；次要的
secondly	ad.第二(点)；其次
secret	a.秘密的；隐蔽的
secretary	n.秘书；书记；大臣
section	n.切片；一段；部门
secure	a.安心的；安全的
security	n.安全，安全感
see	vt.看见；遇见；看出
seed	n.种(子)，籽，萌芽
seek	vt.寻找，探索；试图
seem	vi.好像，似乎
seize	vt.抓住，逮捕；夺取
seldom	ad.很少，不常，难得
select	vt.&vi.选择，挑选
selection	n.选择，挑选；精选物
self	n.自我，自己
selfish	a.自私的，利己的
sell	vt.&vi.卖，销售
seller	n.卖者；行销货
semester	n.半年；学期，半学年
semiconductor	n.半导体
senate	n.参议院，上院
send	vt.送，寄发；派遣
senior	a.年少的；地位较高的
sense	n.感官；感觉；见识
sensible	a.感觉得到的；明智的
sensitive	a.敏感的；灵敏的
sentence	n.判决；句子
separate	a.分离的；个别的
separately	ad.分离地
separation	n.分离，分开；分居
September	n.九月
sequence	n.连续，继续；次序
series	n.连续，系列；丛书
serious	a.严肃的；认真的
seriously	ad.严肃地，认真地
servant	n.仆人，佣人，雇工
serve	vt.为…服务；招待
service	n.服务；行政部门
session	n.会议，一段时间
set	vt.放；安置
setting	n.安装，调整；环境
settle	vt.安排；安放；调停
settlement	n.解决；殖民，殖民地
seven	num.七，七个(人或物)
seventeen	num.十七，十七个
seventh	num.第七；七分之一
seventy	num.七十，七十个
several	a.几个，数个
severe	a.严格的；严厉的
severely	ad.严厉地，严格地
sew	vt.缝制
sex	n.性别，性
shade	n.荫；遮光物
shadow	n.阴影，阴，影子
shady	a.成荫的，阴凉的
shake	vt.摇，使震动
shall	aux.v.将要；必须；应
shallow	a.浅的；浅薄的
shame	n.羞耻，羞愧；羞辱
shampoo	vt.用洗发剂洗
shape	n.形状；情况
share	n.份；份额；股份
sharp	a.锋利的；敏锐的
sharpen	vt.削尖，使敏锐
sharply	ad.锐利地，敏锐地
shave	vt.剃，刮
she	pron.(主格)她
shear	vt.剪；剥夺
shed	vt.流出；散发；脱落
shed	n.棚，小屋；贷棚
sheep	n.羊，绵羊
sheet	n.被单；纸张；薄板
shelf	n.搁板，架子
shell	n.壳；贝壳；炮弹
shelter	n.隐蔽处；掩蔽，庇护
shepherd	n.牧羊人，羊倌
shield	n.盾；防护物
shift	vt.替换，转移
shilling	n.先令
shine	vi.照耀，发光
ship	n.(大)船，海船，舰
shirt	n.(男式)衬衫
shiver	vi.颤抖，哆嗦
shock	n.冲击；震惊
shoe	n.鞋
shoot	vt.发射；射中
shop	n.商店，店铺；车间
shopkeeper	n.店主
shopping	n.买东西，购物
shore	n.滨，岸
short	a.短的；短期的
shortage	n.不足，缺少，不足额
shortcoming	n.短处，缺点
shortly	ad.立刻；简短地
shot	n.发射；弹丸；射门
should	aux.v.将；万一；就
shoulder	n.肩，肩膀；挑起
shout	n.&vi.呼喊，喊叫
show	vt.给…看；表明
shower	n.阵雨；(一)阵；淋浴
shriek	vi.尖声喊叫
shrink	vi.收缩；缩小；退缩
shut	vt.关上，闭上，关闭
shy	a.易受惊的；害羞的
sick	a.有病的；恶心的
sickness	n.疾病
side	n.边，旁边；一方
sideways	ad.斜着，斜向一边地
sigh	n.&vi.叹气，叹息
sight	n.视力；见；情景
sightseeing	n.观光，游览
sign	n.符号；招牌
signal	n.信号
signature	n.署名，签字，签名
significance	n.意义，意味；重要性
significant	n.有意义的；重要的
silence	n.沉默
silent	a.沉默的；寂静无声的
silk	n.蚕丝，丝，丝织品
silly	a.傻的，愚蠢的
silver	n.银；银子；银器
similar	a.相似的，类似的
similarly	ad.类似地，相似地
simple	a.简单的；朴素的
simplicity	n.简单，简易；朴素
simplify	vt.简化，使单纯
simply	ad.简单地；朴素地
sin	n.罪，罪孽
since	conj.从…以来；因为
sincere	a.真诚的；真挚的
sing	vi.&vt.唱，演唱
singer	n.歌唱家，歌手
single	a.单一的；独身的
singular	a.单一的；非凡的
sink	vi.下沉；下垂；降低
sir	n.先生，阁下；…爵士
sister	n.姐妹，姐，妹
sit	vi.坐，就坐
site	n.地点，地基；场所
situation	n.位置；处境；形势
six	num.六，六个
sixteen	num.十六，十六个
sixth	num.第六；六分之一
sixty	num.六十，六十个
size	n.大小；体积；尺码
skate	n.冰鞋；滑冰
sketch	n.略图；速写；概略
ski	n.滑橇
skill	n.技能，技巧；熟练
skilled	a.有技能的，熟练的
skillful	a.灵巧的，娴熟的
skim	vt.掠过，擦过；略读
skin	n.皮；兽皮；外皮
skirt	n.女裙；边缘；郊区
sky	n.天，天空
slam	vt.使劲关，砰地放下
slave	n.奴隶；苦工
slavery	n.奴隶制度；苦役
sleep	n.睡眠
sleepy	a.想睡的；寂静的
sleeve	n.袖子，袖套
slender	a.细长的；微薄的
slice	n.薄片，切片；部分
slide	vi.滑
slight	a.细长的；轻微的
slightly	ad.稍微，有点
slip	vi.滑跤；滑落；溜
slipper	n.拖鞋，便鞋
slippery	a.滑的，使人滑跤的
slit	n.裂缝
slogan	n.标语，口号
slope	n.倾斜；斜面
slow	a.慢的；迟钝的
slowly	ad.慢慢地
slum	n.贫民窟，贫民区
sly	a.狡猾的；躲躲闪闪的
small	a.小的，少的；小型的
smart	a.巧妙的；洒脱的
smell	n.嗅觉；气味
smile	vi.微笑
smog	n.烟雾
smoke	n.烟；抽烟
smooth	a.平滑的；平静的
smoothly	ad.光滑地；平稳地
snake	n.蛇
snow	n.雪
snowstorm	n.雪暴，暴风雪
snowy	a.雪的，下雪的
so	ad.这样；这么；非常
soak	vt.浸，泡
soap	n.肥皂
sob	vi.&n.啜泣，呜咽
sober	a.清醒的；适度的
so-called	a.所谓的，号称的
soccer	n.英式足球
social	a.社会的；社交的
socialism	n.社会主义
socialist	a.社会主义的
society	n.社会；团体；社交界
sock	n.短袜
soda	n.碳酸钠，纯碱；汽水
soft	a.软的；柔和的
softly	ad.柔软地；温柔地
soil	n.泥土，土壤，土地
soil	vt.弄脏
solar	a.太阳的，日光的
soldier	n.(陆军)士兵，军人
sole	n.脚底，鞋底，袜底
sole	a.单独的，唯一的
solely	ad.单独地，唯一地
solemn	a.庄严的；隆重的
solid	a.固体的
soluble	a.可溶的；可以解决的
solution	n.解决，解答；溶解
solve	vt.解答，解释，解决
some	a.&pron.一些，若干
somebody	pron.某人，有人
somehow	ad.由于某种原因
someone	pron.某人，有人
something	pron.某事，某物
sometime	ad.在某一时候；从前
sometimes	ad.不时，有时
somewhat	pron.一点儿
somewhere	ad.在某处
son	n.儿子
song	n.歌唱；歌曲，歌词
soon	ad.不久；早，快
sophisticated	a.老于世故的；高级的
sore	a.痛的；恼火的
sorrow	n.悲痛，悲哀，悲伤
sorry	a.难过的；对不起的
sort	n.种类；类别
soul	n.灵魂；精神；人
sound	a.健康的；完好的
sound	n.声音
soup	n.汤
sour	a.酸的；脾气坏的
source	n.河的源头；根源
south	n.南，南方
southeast	n.东南
southern	a.南方的，南部的
southwest	n.西南
Soviet	n.苏维埃
sow	vt.播(种)
space	n.空间；场地；空白
spacecraft	n.航天器，宇宙飞船
spaceship	n.航天飞船
spade	n.铲，铁锹
span	n.跨距；一段时间
Spanish	a.西班牙的n.西班牙人
spare	vt.节约
spark	n.火花，火星
sparkle	vi.发火花
sparrow	n.麻雀
speak	vi.说话；发言
speaker	n.说话者；扬声器
spear	n.矛，枪
special	a.特殊的；专门的
specialist	n.专家
speciality	n.专业，特长；特产
specialize	vi.成为…专家；专攻
specially	ad.专门地，特别地
specific	a.特有的；具体的
specify	vi.指定，详细说明
specimen	n.样本，标本，样品
spectacle	n.光景，景象；眼镜
speech	n.言语；演说；方言
speed	n.快；速率
spell	vt.拼写
spelling	n.拼字，拼法，拼写法
spend	vt.用钱，花费；度过
sphere	n.球，圆体；范围
spider	n.蜘蛛
spill	vt.使溢出
spin	vt.纺；使旋转
spirit	n.精神；气魄；情绪
spiritual	a.精神的，心灵的
spit	vi.吐
splash	vt.&n.溅，泼，飞溅
splendid	a.壮丽的；显著的
split	vt.劈开
spoil	vt.损坏，糟蹋；宠坏
sponge	n.海绵
sponsor	n.发起者
spontaneous	a.自发的；本能的
spoon	n.匙，调羹
sport	n.运动；运动会
sportsman	n.运动员
spot	n.点，斑点；地点
spray	n.浪花；喷雾
spread	vt.伸开；传播
spring	vi.跳，跃
spring	n.春天，春季
springtime	n.春季，春天
sprinkle	n.洒，撒；小雨
spur	n.刺激物
spy	n.间谍，特务
square	n.正方形；广场
squeeze	vt.&vi.榨，挤；压榨
squirrel	n.松鼠
stab	vt.&vi.&n.刺，戳
stability	n.稳定，稳定性，巩固
stable	a.稳定的，不变的
stable	n.厩，马厩，牛棚
stack	n.堆，垛
stadium	n.露天大型运动场
staff	n.工作人员；参谋
stage	n.舞台；戏剧；阶段
stain	vt.沾污；给…着色
stair	n.楼梯
staircase	n.楼梯，楼梯间
stake	n.桩；赌金；奖品
stale	n.陈腐的；走了气的
stamp	n.戳子；邮票；标志
stand	vi.站；坐落
standard	n.标准
standpoint	n.立场，观点
star	n.星；恒星；明星
stare	vi.盯，凝视
start	vi.跳起；出发；开始
startle	vt.使大吃一惊
starve	vi.饿死
state	n.状态；国家；州
state	vt.陈述，说明，阐明
statement	n.陈述，声明
statesman	n.政治家，国务活动家
static	a.静的；静态的
station	n.站，台，所，局
statistical	a.统计的，统计学的
statue	n.塑像，雕像，铸像
status	n.地位，身分
stay	vi.停留；住
steadily	ad.稳定地，不变地
steady	a.稳固的
steal	vt.偷，窍取
steam	n.蒸汽
steamer	n.轮船，汽船
steel	n.钢，钢铁
steep	a.险峻的，陡峭的
steer	vt.&vi.驾驶
stem	n.茎，(树)干
step	n.(脚)步；步骤
stern	a.严厉的；坚定的
steward	n.乘务员，服务员
stewardess	n.空中小姐，女乘务员
stick	n.棍，棒
sticky	a.粘性的；胶粘的
stiff	a.硬的；僵直的
stiffen	vt.使硬；使僵硬
still	a.静止的
stimulate	vt.刺激，激励，激发
sting	vt.刺；刺痛
stir	vt.动；拨动；激动
stitch	n.一针；针脚
stock	n.原料；库存品；股本
stocking	n.长(统)袜
stomach	n.胃；肚子；食欲
stone	n.石，石头；宝石
stony	a.多石的；冷酷的
stool	n.凳子
stoop	vi.俯身；弯身
stop	vt.塞住；阻止；停止
storage	n.贮藏；贮藏量
store	n.贮藏；贮存品；商店
storey	n.(层)楼
storm	n.风暴；暴(风)雨
stormy	a.有暴风雨的；激烈的
story	n.故事，小说，传说
stove	n.炉，火炉，电炉
straight	a.直的；正直的
strain	vt.拉紧
strange	a.陌生的；奇怪的
stranger	n.陌生人；新来者
strap	n.带子
strategy	n.战略；策略
straw	n.稻草，麦杆吸管
strawberry	n.草莓
stream	n.河；流
street	n.街，街道；行车道
strength	n.力，力量，力气
strengthen	vt.加强，巩固
stress	n.压力；重音
stretch	vt.伸展
strict	a.严格的；严谨的
strictly	ad.严格地，严谨地
strike	vt.&vi.打，击
string	n.线，细绳；一串
strip	vt.剥；夺去
stripe	n.条纹，条子
stroke	n.打，击；鸣声；中风
stroke	vt.&n.抚，摩，捋
strong	a.强壮的；擅长的
strongly	ad.强壮地，强烈地
structural	a.结构的，构造的
structure	n.结构；构造
struggle	n.&vi.斗争，奋斗
student	n.学生；研究生，学者
study	n.学习，研究
stuff	n.材料
stumble	vi.绊倒；犯错误
stupid	a.愚蠢的；感觉迟钝的
style	n.风格；文体；式样
subject	n.题目；学科；主语
submarine	a.水下的
submerge	vt.浸没
submit	vt.使服从
subsequent	a.随后的，后来的
substance	n.物质；实质；本旨
substantial	a.物质的；坚固的
substitute	n.代替人
subtract	vt.减，减去，去掉
suburb	n.郊区，郊外，近郊
subway	n.地道；地下铁路
succeed	vt.继…之后
success	n.成功，成就，胜利
successful	a.成功的，结果良好的
successfully	ad.成功地
succession	n.连续；继任，继承
successive	a.连续的；接连的
such	a.这样的；如此的…
suck	vt.吸，吮，啜；吸收
sudden	a.突然的，意外的
suddenly	ad.突然地
suffer	vt.遭受；忍受；容许
sufficient	a.足够的，充分的
sufficiently	ad.足够地，充分地
sugar	n.糖
suggest	vt.建议；暗示，启发
suggestion	n.建议，意见；暗示
suit	n.起拆，诉讼
suitable	a.合适的；适宜的
sulphur	n.硫(磺)，硫黄
sum	n.总数；金额
summarize	vt.概括，概述，总结
summary	n.摘要，概要，一览
summer	n.夏，夏季
sun	n.太阳，日
Sunday	n.星期日，礼拜日
sunlight	n.日光，阳光
sunny	a.阳光充足的；快活的
sunrise	n.日出(时分)
sunset	n.日落(时分)
sunshine	n.(直射)日光，阳光
super	a.极好的，超级的
superficial	a.表面的；肤浅的
superior	a.较高的；优越的
supermarket	n.超级市场
supper	n.晚饭，晚餐
supplement	n.&vt.增补，补充
supply	vt.&n.供给，供应
support	vt.支撑；支持；供养
suppose	vt.猜想；假定；让
supreme	a.最高的；最大的
sure	a.确信的；确实的
surely	a.确实；稳当地
surface	n.地面，表面；外表
surgeon	n.外科医师；军医
surgery	n.外科，外科手术
surname	n.姓
surprise	vt.使惊奇；突然袭击
surprising	a.惊人的；出人意外的
surprisingly	ad.惊人地
surrender	vt.交出
surround	vt.围，围绕，圈住
surroundings	n.周围的事物，环境
survey	vt.俯瞰；检查；测量
survive	vt.幸免于
suspect	vt.怀疑
suspend	vt.吊，悬；推迟
suspicion	n.怀疑，疑心，猜疑
sustain	vt.支撑；供养；忍受
swallow	n.燕子
swallow	vt.&vi.吞下，咽下
swamp	n.沼泽，沼泽地
swan	n.天鹅
swarm	n.一大群
sway	vi.摇动
swear	vt.宣(誓)
sweat	n.汗
sweater	n.厚运动衫，毛线衫
sweep	vt.扫；刮起；扫过
sweet	a.甜的；愉快的
swell	vi.膨胀；隆起；增长
swift	a.快的；反应快的
swim	vi.游，游泳；眼花
swing	vi.摇摆；回转
Swiss	a.瑞士的
switch	n.开关；转换
sword	n.剑，刀
symbol	n.象征；符号，记号
sympathetic	a.同情的；和谐的
sympathize	vi.同情；同感，共鸣
sympathy	n.同情；一致，同感
synthetic	a.综合的；合成的
system	n.系统，体系；制度
systematic(al)	a.有系统的；有计划的
table	n.桌子；餐桌；项目表
tablet	n.碑，匾；药片
tag	n.附加语；标签
tail	n.尾巴；末尾部分
tailor	n.裁缝
take	vt.拿；抓；拿走；吃
tale	n.故事，传说
talent	n.天才；才能；人才
talk	vi.讲话
tall	n.高的，身材高的
tame	a.驯服的；顺从的
tan	n.棕褐色
tank	n.坦克；大容器，槽
tap	vt.&vi.&n.轻叩
tap	n.塞子；龙头
tape	n.线带；磁带，录音带
target	n.靶，标的；目标
task	n.任务，工作，作业
taste	vt.尝；尝到
tax	n.税，税款；负担
taxi	n.出租汽车
tea	n.茶；茶叶；茶树
teach	vt.讲；教育
teacher	n.教师，老师，先生
teaching	n.教学，讲授；教导
team	n.队，组
tear	n.眼泪，泪珠
tear	vt.撕开，撕裂
technical	a.技术的，工艺的
technician	n.技术员，技师
technique	n.技术，技巧；技能
technology	n.工艺学，工艺，技术
tedious	a.冗长乏味的，沉闷的
teenager	n.青少年
telegram	n.电报
telegraph	n.电报机；电报
telephone	n.电话
telescope	n.望远镜
television	n.电视；电视机
tell	vt.讲述；吩咐；辨别
temper	n.韧度；心情，情绪
temperature	n.温度；体温
temple	n.圣堂，神殿，庙宇
temporary	a.暂时的，临时的
tempt	vt.引诱，诱惑；吸引
temptation	n.诱惑，引诱
ten	num.十，十个
tenant	n.承担人，房客，佃户
tend	vt.照管，照料，护理
tend	vi.走向，趋向；倾向
tendency	n.趋向，趋势，倾向
tender	a.嫩的；脆弱的
tennis	n.网球，网球运动
tense	n.时态，时
tense	a.拉紧的，绷紧的
tent	n.帐篷
tenth	num.第十；十分之一
term	n.期；学期；条件；词
terminal	a.末端的
terrible	a.可怕的；极度的
terrific	a.可怕的；极大的
territory	n.领土，版图；领域
terror	n.恐怖，惊骇
test	n.&vt.试验；检验
text	n.原文，本文；课文
textbook	n.课本，教科书
textile	n.纺织品
than	conj.(比较级)比
thank	vt.谢谢，感谢
that	a.那
the	art.(定冠词)这，那
theatre	n.戏院；戏剧；教室
their	pron.他(她、它)们的
theirs	pron.他(她)们的东西
them	pron.(宾格)他们
themselves	pron.他们自己
then	ad.当时；然后；那么
theoretical	a.理论(上)的
theory	n.理论；学说；意见
there	ad.在那里；在那点上
thereby	ad.因此，从而，由此
therefore	ad.因此，所以
thermometer	n.温度计，寒暑表
these	a.&pron.这些
they	pron.(主格)他(她)们
thick	a.厚的；密的；浓
thickness	n.厚(度)；密(度)
thief	n.窃贼，偷窃犯
thin	a.薄的；淡的
thing	n.物；用品；事；情况
think	vt.想；想要；认为
third	num.第三；三分之一
thirdly	ad.第三
thirst	n.渴，口渴；渴望
thirsty	a.渴的；渴望的
thirteen	num.十三，十三个
thirty	num.三十，三十个
this	a.这；今
thorn	n.刺，棘；荆棘；蒺藜
thorough	a.彻底的；详尽的
those	pron.那些
though	conj.虽然
thought	n.思想；思维；想法
thoughtful	a.沉思的；体贴的
thousand	num.千，千个
thread	n.线；丝；螺纹；头绪
threat	n.威胁，恐吓，凶兆
threaten	vt.&vi.威胁，恐吓
three	num.三，三个
thrill	n.一阵激动
thrive	vi.兴旺，繁荣，旺盛
throat	n.咽喉，喉咙；嗓音
throne	n.宝座，御座；王位
throng	n.群，人群
through	prep.穿过ad.从头到尾
throughout	prep.遍及
throw	vt.投，掷，抛，扔
thrust	vt.插，刺
thumb	n.(大)拇指
thunder	n.雷
Thursday	n.星期四
thus	ad.如此，这样；因而
tick	n.滴答声；记号
ticket	n.票，券；纲领；传票
tide	n.潮，潮汐；潮流
tidy	a.整洁的；整齐的
tie	n.领带；联系
tiger	n.虎
tight	a.紧的；紧身的
till	prep.conj.直到…为止
timber	n.木材，木料
time	n.时间；时机；次，回
timetable	n.时间表，时刻表
timid	a.胆怯的；羞怯的
tin	n.锡；罐头
tiny	a.微小的，极小的
tip	n.梢，末端，尖，尖端
tip	vt.轻击
tire	vi.疲劳，累；厌倦
tired	a.疲劳的；厌倦的
tissue	n.薄绢；薄纸；组织
title	n.标题，题目；称号
to	prep.到，向，达到
toast	n.烤面包
toast	n.祝酒；祝酒词
tobacco	n.烟草，烟叶
today	ad.在今天；现在
toe	n.脚趾，足尖
together	ad.共同，一起
toilet	n.厕所，盥洗室，浴室
tolerance	n.忍受，容忍；公差
tolerate	vt.忍受，容忍，宽恕
tomato	n.番茄，西红柿
tomb	n.坟，冢
tomorrow	ad.在明天
ton	n.吨；大量
tone	n.音；腔调；声调
tongue	n.舌，舌头；语言
tonight	ad.在今夜
too	ad.也，还；太，过分
tool	n.工具，器具，用具
tooth	n.牙齿
top	n.顶；首位
topic	n.题目，论题，话题
torch	n.火炬，火把；手电筒
torrent	n.奔流，激流，洪流
tortoise	n.龟，乌龟
torture	n.拷问；折磨
toss	vt.&vi.扔，抛，掷
total	a.总的
touch	vt.触摸；触动
tough	a.坚韧的；健壮的
tour	n.&vi.旅行，游历
tourist	n.旅游者，观光者
toward(s)	prep.向；对于；接近
towel	n.毛巾，手巾
tower	n.塔
town	n.镇，市镇，城镇
toy	n.玩具，玩物
trace	n.痕迹；丝毫
track	n.行踪；路径；轨道
tractor	n.拖拉机；牵引车
trade	n.贸易；职业
tradition	n.传统，惯例
traditional	a.传统的，惯例的
traffic	n.交通，通行；交通量
tragedy	n.悲剧；惨事，惨案
trail	n.痕迹；小径
train	vt.培养
training	n.训练，锻炼，培养
traitor	n.叛徒，卖国贼
tram	n.(有轨)电车
tramp	n.流浪者，游民
transfer	vt.转移；调动vi.转移
transform	vt.改变；改造；变换
transformation	n.变化；改造；转变
transformer	n.变压器，转换器
transistor	n.晶体管
translate	vt.翻译，译
translation	n.翻译；译文，译本
transmission	n.传送；传动；发射
transmit	vt.传送，传达；发射
transparent	a.透明的；易识破的
transport	vt.运输
transportation	n.运输，运送，客运
trap	n.陷阱；诡计
travel	vi.&vi.&n.旅行
tray	n.(浅)盘，托盘，碟
treason	n.谋反，通敌，叛国罪
treasure	n.财富；珍宝
treat	vt.对待；处理
treatment	n.待遇；治疗，疗法
treaty	n.条约；协议，协定
tree	n.树
tremble	vi.发抖，哆嗦；摇动
tremendous	a.极大的，非常的
trend	vi.伸向；倾向
trial	n.试，试验；审判
triangle	n.三角(形)
tribe	n.部落，宗族
trick	n.诡计；窍门
trifle	n.小事，琐事；少许
trim	a.整齐的
trip	vi.绊；失足
triumph	n.凯旋；胜利
troop	n.军队；一群，大量
tropical	a.热带的
trouble	n.烦恼；困难
troublesome	a.令人烦恼的；麻烦的
trousers	n.裤子，长裤
truck	n.卡车，载重汽车
true	a.真的；忠实的
truly	ad.真正地；忠实地
trumpet	n.喇叭，小号
trunk	n.树干；大衣箱，皮箱
trust	n.信任
truth	n.真理；真实；真实性
try	vt.试；审问
tub	n.桶，盆，浴缸，浴盆
tube	n.管；电子管，显像管
tuck	vt.折短，卷起；塞
Tuesday	n.星期二
tuition	n.教，教诲；学费
tumble	vi.摔倒，跌倒；打滚
tune	n.调子；和谐
tunnel	n.隧道，坑道，地道
turbine	n.叶轮机，汽轮机
turbulent	a.骚动的，骚乱的
turkey	n.火鸡；火鸡肉
turn	vt.转；翻
turning	n.旋转；变向；转弯处
turnip	n.萝卜，芜菁
tutor	n.家庭教师；导师
twelfth	num.第十二
twelve	num.十二，十二个
twentieth	num.第二十
twenty	num.二十，二十个
twice	ad.两次，两倍
twin	a.孪生的
twinkle	vi.闪烁，闪耀
twist	vt.捻；拧
two	num.二，两个
type	n.型，类型
typewriter	n.打字机
typhoon	n.台风
typical	a.典型的，代表性的
typist	n.打字员
tyre	n.轮胎，车胎
U	V
ugly	a.丑陋的；可怕的
ultimate	a.最后的，最终的
ultimately	ad.最终，最后
umbrella	n.伞，雨伞
unable	a.不能的，不会的
unbearable	a.难堪的，忍受不了的
uncertain	a.无常的；不确定的
uncle	n.伯父，叔父，舅父
uncomfortable	a.不舒服的；不自在的
unconscious	a.不省人事的
uncover	vt.揭开…的盖子
under	prep.在…下面；低于.
undergo	vt.经历，经受，忍受
undergraduate	n.大学肆业生
underground	a.地下的；秘密的
underline	vt.划线于…之下
underneath	ad.在下面，在底下
understand	vt.懂；获悉
understanding	n.理解；理解力；协定
undertake	vt.从事；承担；保证
undertaking	n.任务，事业；许诺
undo	vt.解开，打开；取消
undoubtedly	ad.无容置疑，肯定地
uneasy	a.心神不安的，忧虑的
unexpected	a.想不到的，意外的
unfair	a.不公平的，不公正的
unfortunate	a.不幸的；可取的
unfortunately	ad.不幸地
unhappy	a.不幸福的，不快乐的
uniform	a.一样的
union	n.联合；团结；协会
unique	a.唯一的，独一无二的
unit	n.单位；单元；部件
unite	vi.联合
unity	n.单一；统一；团结
universal	a.宇宙的；普遍的
universe	n.宇宙，世界
university	n.大学，综合性大学
unjust	a.非正义的；不公平的
unkind	a.不仁慈的，不和善的
unknown	a.不知道的；未知的
unless	conj.除非，如果不
unlike	a.不同的
unlikely	a.未必的，未必可能的
unload	vt.卸(货)
unlucky	a.不幸的；不吉的
unnecessary	a.不必要的，多余的
unpleasant	a.令人不快的，讨厌的
unsatisfactory	a.不能令人满意的
unstable	a.不稳固的；不稳定的
unsuitable	a.不合适的，不适宜的
until	prep&conj.直到…为止
unusual	a.不平常的；独特的
unusually	a.不平常地，非常
unwilling	a.不愿意的
up	ad.向上；起床，起来
upon	prep.在…上；在…旁
upper	a.上面的；地位较高的
upright	a.垂直的；正直的
upset	vt.弄翻，打翻，倾覆
upside-down	a.颠倒的，乱七八糟的
upstairs	ad.在楼上
up-to-date	a.直到最近的，现代的
upward	a.向上的，上升的
upwards	ad.趋向上升；以上
urge	vt.推进；催促
urgent	a.紧急的；强求的
us	pron.(宾格)我们
usage	n.使用，对待；惯用法
use	vt.用；耗费
used	vi.过去常常
used	a.旧的；习惯于…的
useful	a.有用的，有益的
useless	a.无用的，无价值的
user	n.用户，使用者
usual	a.通常的；平常的
usually	ad.通常
utility	n.效用，有用，实用
utilize	vt.利用
utmost	a.最远的
utter	a.完全的，彻底的
utter	vt.发出，说，讲
vacant	a.空的；未被占用的
vacation	n.假期，休假
vacuum	n.真空；真空吸尘器
vague	a.模糊的，含糊的
vain	a.徒劳的；自负的
valid	a.有效的；正当的
valley	n.(山)谷，溪谷；流域
valuable	a.值钱的；有价值的
value	n.价值；价格
van	n.大篷车，运货车
vanish	vi.突然不见，消失
vanity	n.虚荣心，虚夸
vapour	n.汽，蒸气
variable	a.易变的
variation	n.变化，变动；变异
variety	n.多样化；种类；变种
various	a.各种各样的，不同的
vary	vt.改变；使多样化
vase	n.瓶，花瓶
vast	a.巨大的；大量的
vegetable	n.植物；蔬菜
vehicle	n.车辆，机动车
veil	n.面纱，面罩；遮蔽物
velocity	n.速度，速率
velvet	n.丝绒，天鹅绒
venture	n.&vi.冒险
verb	n.动词
verify	vt.证实，查证；证明
version	n.译文；说法；改写本
vertical	a.垂直的，竖式的
very	ad.很；完全
vessel	n.容器；船，飞船；管
vest	n.汗衫；背心；内衣
veteran	n.老兵，老手
vex	vt.使烦恼，使恼火
via	prep.经过；通过
vibrate	vt.使颤动
vibration	n.颤动，振动；摆动
vice	n.罪恶；恶习；缺点
vice	n.(老)虎钳
victim	n.牺牲者，受害者
victorious	a.胜利的，得胜的
victory	n.胜利，战胜
video	a.电视的
view	n.看；视力；风景
viewpoint	n.观点，看法，见解
vigorous	a.朝气蓬勃的
village	n.乡村，村庄
vine	n.葡萄树
vinegar	n.醋
violence	n.猛烈，激烈；暴力
violent	a.猛烈的；狂暴的
violet	n.紫罗兰
violin	n.小提琴
virtually	ad.实际上，事实上
virtue	n.善；美德；优点
visible	a.可见的，看得见的
vision	n.视；想象力；梦幻
visit	vt.&n.访问，参观
visitor	n.访问者；游客
visual	a.看的；看得见的
vital	a.生命的；有生命力的
vitamin	n.维生素，维他命
vivid	a.鲜艳的；生动的
vocabulary	n.词汇表；词汇，语汇
voice	n.说话声；意见；语态
volcano	n.火山
volleyball	n.排球，排球运动
volt	n.伏特，伏
voltage	n.电压
volume	n.卷，册；容积；音量
voluntary	a.自愿的，志愿的
vote	n.选举，投票，表决
voyage	n.&vi.航海，航空
W	X
wage	n.工资，报酬
wage	vt.开展(运动)
waggon	n.四轮运货马车
waist	n.腰，腰部
wait	vi.等，等候
waiter	n.侍者，服务员
wake	vi.醒，醒来
waken	vi.醒来
walk	vi.&n.走，步行
wall	n.墙，壁，围墙，城墙
wallet	n.钱包，皮夹子
wander	vi.漫游；迷路；离题
want	vt.要
war	n.战争；冲突，斗争
warm	a.温暖的；热烈的
warmth	n.暖和，温暖；热烈
warn	vt.警告
wash	vt.洗；冲出
waste	n.浪费；废物；垃圾
watch	vt.&vi.观看
water	n.水
waterfall	n.瀑布
waterproof	a.不透水的，防水的
wave	n.波；波涛
wavelength	n.波长
wax	n.蜡，蜂蜡
way	n.路；路线；方向
we	pron.(主格)我们
weak	a.弱的；软弱的
weaken	vt.削弱
weakness	n.虚弱，软弱；弱点
wealth	n.财富，财产；丰富
wealthy	a.富的，富裕的
weapon	n.武器，兵器
wear	vt.穿着，戴；磨损
weary	a.疲倦的
weather	n.天气
weave	vt.织，编
wedding	n.婚礼
Wednesday	n.星期三
weed	n.杂草，野草
week	n.星期，周
weekday	n.周日，工作日
weekend	n.周末，周末假期
weekly	a.每周的
weep	vi.哭泣，流泪
weigh	vt.称…的重量；掂量
weight	n.重；砝码；重担
welcome	int.&n.&vt.欢迎
weld	vt.&n.焊接，熔接
welfare	n.幸福，福利
well	n.井
well	ad.好；完全地
well-known	a.众所周知的，出名的
west	n.西；西洋
western	a.西方的，西部的
westward	a.向西的
wet	a.湿的；下雨的
what	pron.什么
whatever	pron.无论什么
wheat	n.小麦
wheel	n.轮，车轮
when	ad.什么时候；当…时
whenever	conj.无论何时，每当
where	ad.在哪里
wherever	ad.究竟在哪里
whether	conj.是否
which	pron.哪一个
whichever	a.无论哪个，无论哪些
while	conj.当…的时候；而
whilst	conj.&n.当…的时候
whip	vt.鞭笞；搅打
whirl	vt.使回旋
whisky	n.威士忌酒
whisper	vt.低声地讲
whistle	n.口哨
white	a.白的
whitewash	vt.粉刷，涂白
who	pron.谁；…的人
whoever	pron.谁；无论谁
whole	a.完整的
wholly	ad.完全地，全部
whom	pron.(宾格)谁
whose	pron.谁的；哪个人的
why	ad.为什么
wicked	a.坏的；令人厌恶的
wide	a.宽阔的
widely	ad.广，广泛
widen	vt.加宽
widespread	a.分布广的，普遍的
widow	n.寡妇
width	n.宽阔，广阔；宽度
wife	n.妻子
wild	a.野生的；野蛮的
will	aux.v.将要，会；愿
willing	a.愿意的，心甘情愿的
win	vi.获胜，赢
wind	n.风；气息，呼吸
wind	vt.绕，缠绕
window	n.窗子，窗户，窗口
wine	n.葡萄酒，果酒
wing	n.翼，翅膀，翅
winner	n.获胜者，优胜者
winter	n.冬天，冬季
wipe	vt.&n.揩，擦
wire	n.金属线；电缆；电信
wireless	a.不用电线的，无线的
wisdom	n.智慧，才智；名言
wise	a.有智慧的，聪明的
wish	vt.祝；想要
wit	n.智力，才智，智能
with	prep.和…一起；具有
withdraw	vt.收回；撤回vi.撤退
within	prep.在…里面
without	prep.无，没有，不
withstand	vt.抵挡，反抗
witness	n.证据；证人
wolf	n.狼
woman	n.妇女，女人，女性
wonder	n.惊异，惊奇；奇迹
wonderful	a.惊人的；极好的
wood	n.树林，森林；木头
wooden	a.木制的；呆板的
wool	n.羊毛；毛线，绒线
woollen	a.羊毛制的，毛线的
word	n.词；话；消息；语言
work	n.工作；职业
worker	n.工人；工作者，人员
workman	n.工人，劳动者，工匠
workshop	n.车间，工场；创作室
world	n.世界；世人；世间
world-wide	a.遍及全球的
worm	n.虫，蠕虫
worry	vt.使烦恼
worse	a.更坏的
worship	n.礼拜；崇拜
worst	a.最坏的
worth	a.值…的
worthless	a.无价值的，无用的
worthwhile	a.值得花时间的
worthy	a.有价值的；值得的
would	aux.v.将；愿；总是
wound	n.创伤，伤
wrap	vt.裹，包，捆
wreath	n.花环，花圈，花冠
wreck	n.失事；残骸
wrist	n.腕，腕关节
write	vt.书写；写
writer	n.作者，作家，文学家
writing	n.书写，写；著作
wrong	a.错误的
X-ray	n.X射线，X光
yard	n.院子，庭院；场地
yard	n.码
yawn	vi.打呵欠
year	n.年；年年
yearly	a.每年的
yell	vi.叫喊
yellow	a.黄(色)的
yes	ad.是，是的
yesterday	n.&ad.昨天，昨日
yet	ad.还；已经
yield	vt.&vi.出产
you	pron.你，你们
young	a.年轻的
your	pron.你的，你们的
yours	pron.你们的(东西)
yourself	pron.你自己；你亲自
youth	n.青春；青年们；青年
youthful	a.年轻的，青年的
zeal	n.热心，热情，热忱
zealous	a.热心的，热情的
zebra	n.斑马
zero	n.零；零点，零度
zone	n.地区，区域，范围
zoo	n.动物园
abbreviation	n.节略，缩写，缩短
abide	vt.遵守
abolish	vt.废除，取消
absent	a.不在意的
absorption	n.吸收；专注
abstract	a.理论上的
absurd	a.不合理的，荒唐的
abundance	n.丰富，充裕
accessory	n.同谋
accord	n.调和，符合；协议
acknowledge	vt.承认；告知收到
acquaint	vt.使认识，使了解
action	n.作用；情节
adhere	vi.粘附；追随；坚持
adjacent	a.毗连的；紧接着的
adjoin	vt.贴近，毗连；靠近
adjustable	a.可调整的，可校准的
administration	n.局(或署、处等)
admiration	n.钦佩；赞美，羡慕
adoption	n.收养；采纳，采取
adore	vt.崇拜；很喜欢
advantageous	a.有利的，有助的
advertise	vt.通知
advocate	n.辩护者
aerial	a.空气的；航空的
aerospace	n.航空和宇宙航行空间
affirm	vt.断言，批准；证实
agitation	n.鼓动，煸动；搅动
agreeable	a.惬意的；同意的
alas	int.唉，哎呀
album	n.粘贴簿；相册；文选
alert	a.警惕的；活跃的
algebra	n.代数学
alien	a.外国的
alignment	n.队列；结盟，联合
allied	a.联合的；联姻的
allowance	n津贴，补助费
alongside	prep.在…旁边
ally	n.盟国，同盟者，伙伴
alteration	n.变更，改变；蚀变
alternate	vt.使交替
amateur	a.业余的n.业余爱好者
ambassador	n.大使，使节
ambient	a.周围的，包围着的
ambiguous	a.模棱两可的；分歧的
ambitious	a.有雄心的；热望的
ample	a.足够的；宽敞的
amplitude	n.广大；充足；振幅
amusement	n.娱乐，消遣，乐趣
analogue	n.类似物；同源语
analogy	n.相似，类似；比拟
analytic(al)	a.分析的；分解的
anniversary	n.周年纪念日
announce	vt.报告…的来到
annually	ad.年年，每年
anode	n.阳极，正极，板极
answer	vi.符合，适合
antarctic	a.南极的
antenna	n.触角；天线
antique	a.古代的
anybody	n.重要人物
apparent	a.显然的
appendix	n.附录，附属物；阑尾
applaud	vt.喝彩；欢呼vi.欢呼
applause	n.喝彩；夸奖，称赞
appreciable	a.可估价的；可察觉的
appreciation	n.欣赏；鉴别；感激
apt	a.恰当的；聪明的
arc	n.弧，弓形物；弧光
arch	n.拱门
architect	n.建筑师；创造者
arctic	a.北极的
array	vt.装扮
ascend	vi.攀登，登高；追溯
ascertain	vt.查明，确定，弄清
ascribe	vt.把…归于
ashore	ad.在岸上，上岸
ass	n.驴；傻瓜，蠢笨的人
assassinate	vt.暗杀，行刺；中伤
assault	vt.袭击；殴打
assert	vt.断言，宣称；维护
assessment	n.估定；查定；估计数
assumption	n.采取；假定；傲慢
assurance	n.保证；财产转让书
astonishment	n.惊奇，惊讶
astronomy	n.天文学
atom	n.微粒；微量
attachment	n.连接物，附件；爱慕
attendance	n.到场；出席人数
attendant	n.侍者；护理人员
attorney	n.代理人；辩护律师
audience	n.正式会见；拜会
author	n.创造者，创始人
automate	vt.使自动化
avail	vt.有益于
availability	n.有效(性)；可得性
aviation	n.飞行
awake	vi.认识到
awful	a.威严的；令人崇敬的
awkward	a.不雅观的
axial	a.轴的；轴向的
axis	n.轴，轴线；第二颈椎
axle	n.(轮)轴，车轴，心棒
baby	n.一家中年龄最小的人
bachelor	n.未婚男子；学士
bacon	n.咸猪肉，熏猪肉
bacterium	n.细菌；拳击迷
badge	n.徽章，像章；标志
baffle	vt.使挫折
bait	n.饵；引诱物
balcony	n.阳台；楼厅，楼座
bald	a.秃头的；无毛的
ballet	n.芭蕾舞；舞剧
bamboo	n.竹；竹杆，竹棍
bandage	n.绷带，包带
bandit	n.土匪，盗匪，歹徒
bank	vi.把钱存入银行
banker	n.银行家
bankrupt	a.破产的
banquet	n.宴会，盛会，酒席
barely	ad.仅仅，勉强
barge	n.驳船；大型游船
barley	n.大麦
barometer	n.气压计，睛雨表
baron	n.男爵；贵族；巨商
barren	a.贫瘠的；不妊的
baseball	n.棒球；棒球运动
basement	n.地下室；地窖；底层
basin	n.内海；盆地，流域
battery	n.炮兵连；兵器群
battle	vi.战斗
bazaar	n.集市，廉价商店
bead	n.有孔小珠；露珠
beam	vi.发光，发热；微笑
bearing	n.支承；忍受；方位
bed	n.河床，(湖)底，矿床
beetle	n.甲虫；近视眼的人
beforehand	ad.预先；提前地
bend	vt.使屈从
bestow	vt.把…赠与
between	ad.当中，中间
beware	vt.&vi.谨防，当心
bewilder	vt.迷惑，把…弄糊涂
bid	vt.命令
bishop	n.(基督教的)主教
bitterness	n.苦味，辛酸，苦难
blacksmith	n.铁匠，锻工
blast	n.管乐器的声音
blaze	vt.使燃烧
bleach	vt.漂白
blind	n.百叶窗；窗帘；遮帘
block	n.阻塞；障碍物；炮闩
blond	n.白肤金发碧眼的人
blouse	n.女衬衫；童衫；罩衫
blue	a.伤心的；下流的
blunder	vi.犯大错
blush	vi.脸红，害臊
board	vt.(收费)供…膳食
body	n.物体；(液)体；实质
boiler	n.锅炉；热水贮槽
bore	n.讨厌的人；麻烦事
bound	a.应当的；必定的
bourgeois	a.资产阶级的；平庸的
box	n.专席
boycott	vt.&n.联合抵制
brace	n.支柱
brand	vt.在…上打烙印
breakdown	n.崩溃，倒塌；失败
breakfast	vi.吃早餐
breed	n.(动物)品种
bribe	n.贿赂
bridegroom	n.新郎
bridge	vt.架桥于，用桥连接
bridle	n.笼子；束缚
brightness	n.明亮，辉煌，聪明
broaden	vt.&vi.放宽，变阔
bronze	n.青铜色
brood	vt.沉思vi.郁闭地沉思
Buddhism	n.佛教，释教
budget	n.预算，预算案
buffalo	n.水牛；水陆坦克
bug	n.虫子；臭虫
bugle	n.军号，喇叭
bull	n.买空的证券投机商
bulletin	告示，公告，公报
bump	vt.撞击
bureaucracy	n.官僚主义；官僚机构
burglar	n.夜盗，窃贼
burial	n.安葬，埋葬，埋藏
burner	n.灯头，煤气头
bushel	n.蒲式耳(容量单位)
butt	n.大酒桶，桶
buzz	vi.(蜂等)嗡嗡叫
bypass	n.旁通管
by-product	n.副产品
cable	n.海底电报
calculus	n.微积分；结石
calibration	n.校准；标定，刻度
can	vt.装罐头
cane	n.(藤等)茎；手杖
cancel	vt.删去，勾销，取消
capability	n.能力，才能；性能
capacitance	n.电容，电容量
capacitor	n.电容器
cape	n.披肩，斗篷；海角
captive	a.被俘虏的；被迷住的
carry	vt.刊登
cartoon	n.漫画，动画片
cartridge	n.弹药筒，子弹；软片
catalogue	vt.为…编目录
catalyst	n.催化剂；刺激因素
category	n.种类，类目；范畴
cater	vi.迎合，投合
Catholic	a.天主教的n.天主教徒
caution	n.小心；告诫
cautious	a.小心的，谨慎的
cavity	n.洞，穴，空腔
cement	vt.粘结
censor	vt.审查，检查
cereal	n.谷类，五谷，禾谷
certainty	n.确实性，确信，确实
challenge	n.艰巨任务；要求回避
champion	n.斗士；提倡者
characterize	vt.表示…的特性
charcoal	n.炭，木炭；生物炭
charge	n.负荷；充电
charm	n.魅力；妩媚
charter	vt.租
chatter	vi.&n.喋喋不休
cheat	n.欺诈；骗取
check	n.支票，帐单
cherish	vt.珍爱；怀有(感情)
chestnut	n.栗子；栗树；栗色
chill	vi.感到寒冷；冷淬
chip	n.薄片，碎片
choice	n.入选者
chop	n.一块排骨，肉块
chord	n.(乐器的)弦
chorus	vt.&vi.合唱
Christ	n.救世主(耶稣基督)
Christian	a.基督教的
cigar	n.雪茄烟，叶卷烟
circular	n.传单，通报，通函
circulation	n.循环；(货币等)流通
circus	n.马戏；马戏团
cite	vt.引用，引证；举例
civilian	n.平民
claim	n.权利，所有权
clamp	n.夹子
clap	n.拍手喝采声；霹雳声
clash	n.碰撞声；抵触，冲突
clasp	vt.扣住，扣紧，钩住
classic	n.名著
clatter	n.得得声，卡嗒声
cleanliness	n.清洁
clearing	n.(森林中的)空旷地
client	n.顾客；诉讼委托人
climax	n.(兴趣的)顶点
cling	vi.粘住；依附；坚持
clinic	n.诊所，医务室；会诊
clip	vt.夹住
clip	vt.剪；剪辑报刊
cloak	vt.掩盖，覆盖，掩饰
clockwise	a.&ad.顺时针方向转的
closet	n.小房间；壁碗橱
cloudy	a.混浊的；模糊不清的
clown	n.(马戏的)小丑，丑角
cluster	n.一串
clutch	vt.抓住
coach	vt.辅导，指导，训练
cock	n.旋塞，开关，龙头
coefficient	n.协同因素；系数，率
coffin	n.棺材，柩
coherent	a.粘着的；紧凑的
coin	vt.铸造(硬币)
coincide	vi.相符合；相巧合
coke	n.焦炭
collaborate	vi.协作，合作；协调
collide	vi.碰撞；冲突，抵触
colonial	a.殖民地的，殖民的
colonist	n.移民；殖民地居民
combat	vt.跟…战斗
combustion	n.燃烧；氧化；骚动
comedy	n.喜剧；喜剧场面
commence	vt.开始
commend	vt.称赞，表扬；推荐
commission	n.委托，委任；委托状
commodity	n.日用品，商品，物品
commonplace	a.平凡的
commonsense	a.有常识的
commonwealth	n.共和国；联邦
compact	a.紧密的
comparable	a.可比较的；类似的
compatible	a.一致的；兼容制的
compensate	vt.&vi.补偿，赔偿
compensation	n.补偿，赔偿，赔偿费
competitive	a.竞争的，比赛的
competitor	n.竞争者，敌手
complaint	n.疾病，病痛；主诉
complement	vt.补充
completion	n.完成，结束，完满
complexity	n.复杂(性)
complication	n.复杂，混乱；并发症
compliment	n.问候
comply	vi.应允，遵照，照做
composer	n.作曲家；调停人
composite	a.合成的
composition	n.组成，构成，结构
comprehend	vt.了解，理解，领会
compression	n.压缩，压紧，浓缩
compulsory	a.强迫的，义务的
conceit	n.自负，自高自大
conceive	vt.设想，以为；怀孕
concentrate	vt.&vi.浓缩，提浓
conception	n.概念，观念，想法
concern	n.所关切的事；商行
concert	n.一齐，一致，协作
concession	n.让步，迁就
confidence	n.私房话，秘密，机密
confidential	a.秘密的；亲信的
confirmation	n.证实，确定；确认
conform	vt.使遵守
confront	vt.使面对；使对证
conqueror	n.征服者，胜利者
consciousness	n.意识，知觉，觉悟
consequence	n.重要(性)，重大意义
consequent	a.作为结果的；必然的
conservative	a.有保存力的，防腐的
consistent	a.前后一致的，连贯的
console	n.悬臂，肘托；控制台
consolidate	vt.巩固
constituent	a.形成的
constitute	vt.构成，组成
constitution	n.(人的)体格，素质
constraint	n.强迫，结束；强制力
construction	n.结构；作图(法)
consul	n.领事
consumer	n.消费者，用户
consumption	n.消费(量)，灭绝
contend	vi.竞争
context	n.上下文；来龙去脉
continental	a.大陆的，大陆性的
contradict	vt.反驳，否认
contrary	n.反对命题
contrast	vt.使对比vi.形成对比
controversy	n.争论，辩论，争吵
convention	n.公约，(换俘等)协定
convert	vt.转变，改变，变换
convey	vt.传达；传播；转让
conviction	n.确信，信服，深信
cooperative	a.合作的
coordinate	a.同等的
correctly	ad.正确地，恰当地
correlate	n.互相关联的事物
correlation	n.相互关系；对射
correspondence	n.通信；符合；对应
corrosion	n.腐蚀，侵蚀；锈
corrupt	vt.贿赂
cosmic	a.宇宙的；广大无边的
cosmos	n.宇宙；秩序，和谐
couch	n.睡椅，长沙发椅
counsel	n.商议；忠告；律师
count	n.起拆理由，罪状
counter	a.&ad.相反的(地)
courageous	a.勇敢的，无畏的
courteous	a.有礼貌的，谦恭的
courtesy	n.礼貌，谦恭，请安
coward	a.懦怯的，胆小的
crab	n.蟹，蟹肉
crack	vi.&vt.发出爆裂声
cradle	n.摇篮，发源地
craft	n.技巧
crank	n.曲柄
crash	vi.撞坏，摔坏，砸碎
credit	vt.&n.相信，信任
crisis	n.危机；转折点
crisp	a.脆的；卷曲的
criterion	n.标准，准则，尺度
crooked	a.弯的，歪的；畸形的
cross	a.易怒的；杂交的
cruelty	n.残酷；残酷行为
cruise	vi.巡航
cubic	a.立方体的；立方的
cuckoo	n.杜鹃，布谷鸟
curly	a.卷曲的；有卷毛的
currency	n.通货；通用；市价
currently	ad.普遍地；当前
custom	n.海关，关税
customary	a.通常的；照惯例的
cutter	n.用于切割的器械
cylinder	n.圆筒；柱(面)；汽缸
damn	vt.诅咒
datum	n.资料；数据；已知数
dazzle	vt.&vi.炫耀；迷惑
deafen	vt.使聋；使隔音
deal	vi.做买卖；对付
dealer	n.商人，贩子；发牌者
dean	n.(大学)院长，系主任
decay	vt.使腐朽，使腐烂
decidedly	ad.明确地，坚决地
decimal	a.小数的，十进制的
decisive	a.决定性的；果断的
declaration	n.宣布，宣言；申诉
decline	vt.下倾；偏斜；衰退
decompose	vt.&vi.腐败；分解
decorative	a.装饰的；可作装饰的
decree	n.法令，政令；教令
dedicate	vt.奉献；献身
deem	vt.认为，相信
deepen	vt.加浓
default	n.&vi.不履行；缺席
deficiency	n.缺乏；不足之数
deficient	a.缺乏的；欠缺的
define	vt.规定；立(界限)
deflect	vt.&vi.(使)偏斜
deflection	n.偏斜，歪斜；偏差
deform	vt.损坏…的形状
deformation	n.损坏；变形；畸形
defy	vt.向…挑战；蔑视
degradation	n.降级；退化；衰变
degrade	vt.使降给；使堕落
delegate	n.代表，委员，特派员
deliberate	a.深思熟虑的；审慎的
deliberately	ad.审慎地，故意地
denial	n.否定；拒绝相信
denote	vt.指示，意味着
denounce	vt.谴责，声讨；告发
dentist	n.牙科医生
dependant	n.受赡养者；侍从
deposit	n.押金；寄存物
deposition	n.免职，罢免；口供
depression	n.消沉；不景气萧条期
deprive	vt.夺去；使(人)失去
deputy	n.代理人
derivation	n.引出；起源；衍生
descendant	n.子孙，后裔；弟子
descent	n.下降；出身；斜坡
desert	vt.遗弃；擅离(职守)
designate	vt.指出，指示；指定
desolate	a.荒芜的；孤独的
dessert	n.甜点心
destine	vt.命定，注定；预定
destiny	n.命运，天数
destructive	a.破坏(性)的，危害的
detach	vt.分开；派遣(军队)
detail	n.琐碎，小事
detain	vt.耽搁；扣押，拘留
detective	n.侦探，密探
detector	n.发觉者，探测器
develop	vt.使(颜色等)显现
deviate	vt.(使)背离，偏离
deviation	n.背离，偏离；偏差数
devotion	n.献身，热诚，专心
devour	vt.吞食；吞灭，毁灭
diagnose	vt.诊断(疾病)
dictator	n.独裁者，专政者
diesel	n.柴油发动机，内燃机
diet	n.饮食，食物
difficult	a.难以满足的
dignity	a.尊贵；(举止)庄严
diminish	vt.减少，减小，递减
dine	vi.吃饭
dioxide	n.二氧化物
diploma	n.毕业文凭，学位证书
diplomatic	a.外交的；有策略的
directory	n.姓名地址录；董事会
disagreement	n.不一致；争论
disappearance	n.消失，消散；失踪
disastrous	a.灾难性的；悲惨的
discern	vt.看出，辨出；辨别
discount	n.折扣；打折扣卖
discourse	n.讲话，演说，讲道
discrimination	n.辨别；识别力；歧视
disgrace	n.失宠，耻辱，丢脸
disillusion	n.觉醒
dismay	n.惊慌，沮丧，灰心
dismiss	vt.忘掉
disorder	n.疾病，小病
dispatch	vt.派遣；调度
disperse	vt.(使)分散；驱散
displace	vt.移置；取代；置换
displacement	n.移置；免职；置换
disregard	vt.不管，不顾
dissatisfaction	n.不满，不平
dissipate	vt.驱散；浪费vi.消散
dissolve	vt.解除(婚约等)
distinct	a.独特的
distinctly	ad.显然，清楚地
distinguish	v.使显出特色，使杰出
distort	vt.歪曲，曲解，扭曲
distortion	n.弄歪，歪曲；畸变
distract	vt.分散(心思)；打扰
disturbance	n.动乱；干扰；侵犯
diverge	vi.分岔；分歧
diversion	n.转移；改道；娱乐
divert	vt.使转向
divine	a.神的；敬神的
dizzy	a.头晕眼花的，眩晕的
dock	vt.把…引入船坞
doctrine	n.教义，主义；学说
documentary	a.纪录的，文献的
dome	n.圆屋顶，拱顶
domestic	a.养在家里的
dominant	a.统治的
dominate	vt.统治，支配，控制
doom	n.命运，毁灭
doubtless	ad.无疑地；很可能
dove	n.鸽子，斑鸠
drain	vi.(水等)流掉
drainage	n.排水；下水道
drama	n.戏剧性事件；戏剧性
drastic	a.激烈的；严厉的
drawback	n.退款；妨碍；弊端
dreadful	a.可怕的；令人敬畏的
dry	a.干巴巴的，枯燥的
duke	n.公爵，君主；手
duplicate	n.复制品
dust	n.垃圾，废品，灰烬
dwarf	n.矮子，侏儒
dwell	n.居住
dynamic(al)	a.机能上的
dynamo	n.发电机
ear	n.(稻麦等的)穗
earnings	n.工资，收入；收益
earthenware	n.陶器
eastward	a.&ad.向东的，向东
echo	vt.反射(声音等)
eclipse	n.(日，月)食
ecology	n.生态学；个体生态学
economically	ad.节约地，在经济上
economics	n.经济学；经济
edit	vt.编辑，编纂；校订
editorial	n.社论，期刊的社论
Egyptian	a.埃及的
eject	vt.逐出，排斥；喷射
elapse	vi.(时间)过去，消逝
elbow	vt.用肘挤，挤进
electrician	n.电工，电气技师
electrode	n.电极；电焊条
electronics	n.电子学
elegant	a.(举止、服饰)雅致的
elemental	a.基本的；自然力的
elevate	vt.提高(思想)；抬高
elevation	n.高度；标高；隆肿
elliptical	a.椭圆的；省略的
eloquence	n.雄辩；口才，修辞
embarrass	vt.使负债；使复杂化
embassy	n.大使馆；大使的职务
embody	vt.体现；包含，收录
embrace	vt.包括，包含；包围
embroidery	n.绣花，刺绣；绣制品
emerge	vi.浮现，出现；显露
emigrate	vi.永久移居国外
emission	n.散发；传播；发出物
empirical	a.经验主义的
enchant	vt.迷住；用魔法迷惑
enclosure	n.围绕；围场，围栏
end	n.目标，目的
endanger	vt.危及，危害
endeavor	vi.&n.努力，尽力
endow	vt.资助；赋予，授予
endurance	n.耐久力，持久力
energetic	a.积极的；精力旺盛的
energize	vt.给与…能量；电压
engage	vt.使(齿轮等)啮合
engagement	n.婚约；约会，债务
enhance	vt.提高，增加；夸张
enlighten	vt.启发，开导；启蒙
enrich	vt.使富裕；使丰富
enroll	vt.登记，招收vi.参军
enterprise	n.艰巨的事业；事业心
entertainment	n.招待，招待会
entitle	vt.把…称作
entreat	vt.&vi.恳求
entry	n.通道；条目
environmental	a.环境的，环境产生的
episode	n.一段情节；插曲
epoch	n.(新)时代；历元
equation	n.平衡；平均；反应式
equator	n.赤道，天球赤道
equilibrium	n.平衡，均衡；均衡论
equivalent	a.等面(体)积的
erect	a.竖起的
erosion	n.腐蚀，侵蚀；糜烂
escort	n.&vt.护卫，护送
essence	n.本质，本体；精华
essential	a.特发的；自发的
establish	vt.使…被永久地接受
estate	n.房地产；财产，产业
eternal	n.永久的；不朽的
evaporate	vt.使脱水vi.发散蒸气
even	a.同一日期的
evenly	ad.一致地，平静地
everlasting	a.永久的；持久的
evil	n.邪恶，罪恶；祸害
evolution	n.开方；(天体的)形成
excel	vt.胜过
except	vt.把…除外，除去
exceptional	a.例外的；优越的
excess	n.过度行为，暴行
excessively	ad.过分，极端地
exclamation	n.呼喊，惊叫；感叹
exclusive	a.除外的；孤傲的
excursion	n.离题
excuse	vt.与…辩解；使免除
execution	n.实行，执行；处死刑
executive	n.总经理，董事
exemplify	vt.举例证明(解释)
exert	vt.发挥(威力)，施加
exile	vt.流放
expect	vt.料想，认为
expedition	n.探险；探险队
expenditure	n.(时间等)支出，消费
expel	vt.驱逐，开除；排出
experimentally	ad.实验上，实验性地
experimentation	n.实验，试验；实验法
expire	vi.满期，到期；断气
explicit	a.明晰的；直率的
exploration	n.考察；勘探；探查
exposition	n.说明，解释；陈列
extinct	a.绝种的；熄灭了的
extinguish	vt.熄灭，扑灭；消灭
extra	n.附加物；额外的人手
extract	vt.取出；榨取
extraction	n.抽出；提取法；摘要
extraordinarily	ad.非常地，特别地
extravagant	a.奢侈的；过度的
extreme	n.极端不同的性质
fabricate	vt.制作，组合；捏造
fabrication	n.制作，构成；捏造
facilitate	vt.使容易；助长
faction	n.派别，宗派，小集团
fair	a.美丽的
fake	n.假货，膺品
fall	vi.变成，成为；陷于
fantastic	a.空想的；奇异的
fascinate	vt.迷住
fastener	n.扣件，钮扣，揿钮
faultless	a.无过失的；无缺点的
fearless	a.无畏的，大胆的
feel	vi.摸起来
fell	vt.砍倒(树等)；砍伐
fellowship	n.伙伴关系；联谊会
feminine	a.女性的；女子气的
fence	n.击剑(术)
ferrous	a.铁的；亚铁的
ferry	n.渡船；渡口
fertile	a.(创造力)丰富的
fighter	n.斗争者；战斗机
filament	n.细丝；长丝；灯丝
fill	vt.担任(职务)；填补
filter	vi.滤过
filth	n.污秽，污物；淫猥
finance	vt.提供资金
finely	ad.精细地，美好地
finite	a.有限的；有尽的
fireplace	n.壁炉
firework	n.爆竹，花炮，烟火
firmness	n.坚固，坚定，稳固
first-rate	a.第一流的，优秀的
fission	n.裂开；分裂生殖
fitness	n.适当，恰当；健康
fitting	a.适当的
fixture	n.固定；定期存款
flake	n.片，薄片；肌膈
flame	vi.发火焰
flank	n.肋，肋腹；侧面
flannel	n.法兰绒；法兰绒衣服
flap	vt.&n.拍打
flask	n.瓶；火药筒；砂箱
flatten	vt.把…弄平；击倒
flatter	vt.奉承，阿谀，谄媚
flavour	vt.给…调味
flaw	n.缺点，瑕疵；裂隙
flee	vi.逃走
flexible	a.灵活的，可变通的
flight	n.溃退，逃跑；外流
fling	vi.&vt.(用力)扔，抛
float	n.漂浮物；浮标，木筏
flock	vi.群集，聚集
fluctuate	vi.波动
fluctuation	n.波动；脉动；踌躇
flush	n.兴奋，脸红；发烧
flutter	vi.(鸟)振翼；飘动
flux	n.流；涨潮；流量
fly	v.飞跑，逃跑，消失
foam	n.泡沫；泡沫塑料
follow	vt.从事(职业)，经营
follower	n.契据的附面；从动件
footpath	n.小路，人行道
fore	ad.在前面
foreign	a.无关的
foresee	vt.预见，预知，看穿
forge	vt.打(铁等)，锻造
formal	a.形态的；规范的
formerly	ad.以前，从前
formidable	a.可怕的；难对付的
formulate	vt.用公式表示
formulation	n.明确的表达
forsake	vt.遗弃，抛弃，摒绝
fort	n.要塞，堡垒
forthcoming	a.即将到来的；现有的
fortress	n.堡垒，要塞
forum	n.论坛，讨论会
forward	ad.向前，将来vt.转递
fossil	n.化石
foster	vt.养育，抚养；培养
foul	a.肮脏的；丑恶的
fowl	n.家禽；禽肉
fraction	n.分数；分馏的部分
fracture	n.破裂；裂痕
fragile	a.脆的；体质弱的
fragrant	a.香的，芬芳的
frail	a.脆弱的；意志薄弱的
framework	n.机构，组织，体制
freight	n.运费；货运；负担
frequency	n.频繁，屡次；频率
frequent	a.常见的；频繁的
freshen	vt.使显得新鲜
fret	vt.&vi.(使)烦恼
friction	n.擦热皮肤
fright	n.惊吓，恐怖
frightful	a.可怕的；讨厌的
fringe	n.穗，毛边；边缘
fro	ad.往，去，回，向后
frock	n.(女)上衣，罩衫
frustrate	vt.挫败；使无效
furious	a.狂暴的；强烈的
further	vt.增进
fury	n.狂怒，暴怒；猛烈
fuse	n.保险丝，导火线
fuss	n.忙乱；吹捧
gamble	n.赌博
gangster	n.匪徒，歹徒，暴徒
gap	n.山口，山峡；差距
garage	n.汽车修理站；飞机库
garlic	n.蒜，大蒜
garment	n.衣服；服装，衣着
gather	vt.推测，推断
gathering	n.集会，聚会，聚集
gear	n.齿轮，传动装置
generalization	n.一般化；概括，综合
generalize	vt.概括出vi.形成概念
generate	vt.发生，产生；生成
generosity	n.慷慨，宽宏大量
geographical	a.地理的；地区(性)的
geology	n.地质学；(某地)地质
geometrical	a.几何学的
germ	n.细菌，病原菌；幼芽
gesture	vi.(讲话时等)做手势
gigantic	a.巨大的；巨人似的
ginger	n.姜，生姜
gleam	n.微光
glider	n.滑翔机；滑翔导弹
global	a.球面的；全球的
glorify	vt.赞美(上帝)；颂扬
glossary	n.词汇表；术语汇编
glue	vt.粘牢
gnaw	vt.啃，咬断
goddess	n.女神；绝世美女
goodness	n.善良，善行，美德
gorilla	n.大猩猩；暴徒，打手
gorgeous	a.绚丽的；极好的
gossip	n.闲谈；碎嘴子；漫笔
govern	vt.决定，支配；控制
grab	vt.&vi.攫取，抓取
gracious	a.谦和的
gradient	n.斜坡
gramophone	n.留声机
granite	a.花岗岩，花岗石
grant	n.授予物，拨款
graphite	n.石墨，石墨电极
grasshopper	n.蚱蜢，蝗虫，蚂蚱
grassy	a.草多的；草似的
grateful	a.可喜的，令人愉快的
gravel	n.砂跞；砂砾层；结石
graze	vi.喂草；放牧(牲畜)
grease	n.动物脂，脂肪
greed	n.贪心，贪婪
grief	n.悲哀，悲痛，悲伤
grim	a.冷酷无情的，严厉的
grin	vi.咧着嘴笑
grind	vt.折磨，压榨
groove	n.槽
grope	vi.(暗中)摸索，探索
gross	a.(语言、举止)粗俗的
grove	n.林子，小树林，园林
growl	vi.(狗等)嗥叫；咆哮
grumble	vi.抱怨，发牢骚
grunt	vi.作呼噜声；咕哝
guilt	n.有罪，犯罪；内疚
guitar	n.吉他，六弦琴
gust	n.阵风，一阵狂风
gutter	n.沟，边沟；檐槽
hail	vt.向…欢呼
halve	vt.对分；平摊
ham	n.火腿；(兽类的)后踝
hamper	vt.妨碍，阻碍，牵制
handbook	n.手册，便览，指南
handicap	vt.妨碍，使不利
handout	n.施舍物，救济品
handy	a.方便的；便于使用的
harbour	vt.隐匿，窝藏；怀着
hard	a.(酒)烈性的
hardy	a.强壮的，耐劳的
harmonious	a.和谐的，协调的
harp	n.竖琴；天琴座
harsh	a.粗糙的；严厉的
hatch	vt.舱盖，舱口；短门
haughty	a.傲慢的，轻蔑的
haul	vt.拖曳；拖运
haunt	vt.常去
hazard	vt.使遭危险
head	vt.用头顶(球)vi.出发
heading	n.标题，题词，题名
headlong	a.&ad.头向前的(地)
headquarters	n.总局，总店
hearth	n.壁炉地面；炉边
heater	n.加热的人，加热器
hearty	a.衷心的；丰盛的
heave	vt.(用力地)举起；抛
Heaven	n.上帝，神
heighten	vt.加高，提高；增加
hemisphere	n.半球；半球地图
henceforth	ad.今后，从今以后
herald	ad.传令官；通报者
herb	n.草本植物；香草
herd	vt.放牧
hesitate	vi.含糊，支吾；口吃
hide	n.生皮，兽皮，皮革
hike	vi.作长途徒步旅行
hindrance	n.障碍，妨碍
hinge	n.合页，折叶，铰链
hip	n.臀部，髋；屋脊
hiss	n.嘶嘶声
historian	n.历史学家；编史家
historic	a.历史的；历史性的
hit	n.轰动一时的人(或事)
hitherto	ad.迄今，到目前为止
hoarse	a.(声音)嘶哑的
hoe	vt.&vi.锄地
hoist	vt.升起
hollow	vt.凿空
homely	a.家庭的；家常的
homogeneous	a.同类的；均匀的
hook	vt.用钩连接，用钩挂
hop	vi.跳舞；(人)单足跳
horizon	n.层位
horn	n.角状物，角制品
hose	n.长筒袜；软管
hospitality	n.好客，殷勤；宜人
hostage	n.人质，抵押品
hostess	n.女主人；旅馆女老板
hostile	a.敌对的；不友好的
hound	n.狗；角鲨；卑鄙的人
house	n.议院，会议厅
hover	vi.徘徊；傍徨；翱翔
howl	n.嚎叫；哀号
hug	vt.搂
hull	n.外壳，豆荚；薄膜
hum	n.嗡嗡声
humanitarian	a.博爱的
humanity	n.人类；人性，人情
humidity	n.湿气；湿度
hurl	vt.猛投
hurrah	int.好哇，万岁，乌拉
hurricane	n.飓风，十二级风
hurt	n.损伤，伤害，创伤
hush	n.沉默
hydraulic	a.水力的；水力学的
hydrocarbon	n.烃，碳氢化合物
hymn	n.赞美诗，圣歌；赞歌
hypothesis	n.假设；前提
ice	vt.使成冰
icy	a.冰冷的；冷冰冰的
idealism	n.唯心主义；理想主义
ideally	ad.理想地；理论上
identical	a.同一的；恒等的
identification	n.认出，鉴定；身份证
idiot	n.白痴；傻子
idleness	n.懒惰；赋闲无事
ignite	vt.引燃
ignorance	n.无知，无学，愚昧
illiterate	a.文盲的
illuminate	vt.照明，照亮；阐明
illusion	n.幻想；错觉；假象
imitation	n.仿制品，伪制物
immerse	vt.沉浸；给…施洗礼
immigrate	vt.(使)移居入境
immortal	a.不朽的；永生的
impart	vt.给予，传递；告诉
impartial	a.公正的，无偏见的
implement	n.工具，服装
implore	vt.乞求，恳求，哀求
impose	vi.利用；欺骗
impress	vt.盖印，在…打记号
improper	a.不适当的；不合理的
impulse	n.推动，冲力；冲动
impurity	n.不纯；杂质；不道德
inaccessible	a.达不到的，难接近的
inaccurate	a.不精密的，不准确的
inadequate	a.不充足的，不适当的
inasmuch	ad.因为，由于
inaugurate	vt.开始；使就职
incapable	a.无能力的；无资格的
incense	n.香，熏香；香气
incidence	n.发生，影响；入射
incidentally	ad.附带地；顺便提及
inclination	n.倾斜，点头；斜坡
incline	n.坡度
inclusive	a.包围住的；包括的
incompatible	a.不相容的
incomplete	a.不完全的，未完成的
incorporate	vt.结合，合并，收编
incredible	a.难以置信的，惊人的
indefinite	a.无限期的
indicative	a.指示的；陈述的
indignation	n.愤怒，愤慨，义愤
indispensable	a.必不可少的，必需的
individual	a.特殊的
indoor	a.室内的；室内进行的
induce	vt.劝诱；引起；感应
induction	n.就职；归纳推理
indulge	vt.放纵(感情)vi.纵情
industrious	a.勤劳的，勤奋的
inertia	n.惯性，惯量；无力
inevitably	ad.不可避免地
infect	vt.使受影响
infectious	a.传染的；感染性的
infer	vt.&vi.猜想，臆测
inference	n.推论；推断的结果
inferior	n.下级；晚辈，次品
infinite	n.无限；无穷(大)
infinitely	ad.无限地，无边地
infinity	n.大量，大宗；无穷大
inflation	n.通货膨胀，物价飞涨
influence	n.势力，权势
ingenious	a.机灵的；精巧制成的
ingenuity	n.机灵；设计新颖
ingredient	n.配料，成分
inherent	a.固有的，生来的
initial	a.词首的
initially	ad.最初，开始
initiate	vt.开始，创始；启蒙
initiative	a.创始的
inject	vt.注射；注满；喷射
inland	a.国内的；内地的
inlet	n.进口，水湾
innovation	n.创新，改革，新设施
innumerable	a.无数的，数不清的
inorganic	a.无生物的；无机的
input	vt.输入
insert	vi.(肌肉)附着
insight	n.洞察力，洞悉，见识
insignificant	a.无意义的；低微的
insistent	a.坚持的；逼人注意的
inspector	n.检查员；巡官
inspiration	n.灵感；妙想；鼓舞
instability	n.不稳定性；不坚决
installment	n.分期付款
instantaneous	a.瞬间的，即刻的
instructor	n.指导者，教员
instrumental	a.仪器的；有帮助的
insulate	vt.使绝缘，使绝热
insulator	n.隔离者；绝缘体
intake	n.吸入；输入能量
integral	a.组成的；整的
integrate	vt.使结合，使并入
integrity	n.诚实，正直
intellect	n.理智，智力，才智
intent	a.目不转睛的，热切的
interact	vi.相互作用
interconnect	vt.使互相联系
intercourse	n.交际，往来，交流
interface	n.分界面
interior	n.内部
intermediate	n.中间体；调解人
interpret	vt.解释
intervene	vi.干涉，干预；播进
interview	vt.接见，会见，会谈
intonation	n.语调，声调；发声
introduce	vt.提出(议案等)
invalid	n.病人
invariably	ad.不变地，永恒地
inversely	ad.相反地
invoice	n.发票，发货清单
ion	n.离子
irregularity	n.不规则；不整齐
irrespective	a.不考虑的，不顾的
irrigation	n.灌溉；冲洗法
irritate	vt.激怒；引起不愉快
Islam	n.伊斯兰教，回教
ivory	n.象牙；牙质；乳白色
jack	n.起重器；传动装置
jam	n.堵塞
jealousy	n.妒忌，嫉妒，猜忌
jean	n.斜纹布，牛仔裤
jelly	n.冻，果子冻；胶状物
jerk	vt.猛地一拉
Jesus	n.耶稣
jewellery	n.珠宝，珠宝饰物
jingle	vt.&vi.(使)丁当响
jog	vt.使(马等)缓步行进
jug	n.带柄水罐，大壶
junction	n.连接；接头；中继线
jungle	n.丛林，密林，莽丛
junior	n.年少者；晚辈
Jupiter	n.丘庇特；木星
kernel	n.(果实的)核；谷粒
kidnap	vt.诱拐，绑架
kidney	n.肾，腰子；性格
kilowatt	n.千瓦(特)
kindle	vt.点燃
kinetic	a.动力(学)的；活动的
kit	n.成套工具；用具包
knight	n.骑士，武士；爵士
lace	vi.系带，用带子束紧
landscape	n.风景，景色，景致
largely	ad.大规模地
late	a.去世不久的
latent	a.存在但看不见的
lathe	n.车床
latitude	n.纬度；黄纬
lattice	n.格子；点阵，网络
laundry	n.送洗衣店去洗的东西
leaflet	n.传单，活页；广告
leakage	n.漏，泄漏；漏出物
lease	n.租约，契约，租契
legislation	n.立法；法规
length	n.程度，范围
lengthen	vt.使延长
leopard	n.豹
lessen	vt.减少
lever	n.途径，工具，手段
liability	n.责任；倾向；债务
liable	a.有(法律)责任的
lighter	n.打火机，引燃器
likelihood	n.可能(性)
likeness	n.同样；类似，相似
lily	n.百合，百合花，睡莲
limb	n.分支，突出物
limestone	n.石灰石
limp	vi.蹒跚，跛行
line	vt.加衬里于
linear	a.线的；长度的
liner	n.班船，定期班机
linger	vi.逗留，徘徊；拖延
lining	n.(衣服里的)衬里
lipstick	n.唇膏，口红
literal	a.文字(上)的；字面的
literally	ad.照字义，逐字地
literary	a.精通文学的
litter	n.废物，杂乱
lobby	n.前厅，(剧院的)门廊
locality	n.位置，地点，发生地
location	n.定位，测位；测量
locomotive	a.运动的；机动
locust	n.蝗虫；洋槐，刺槐
lodging	n.寄宿，住宿；住所
lofty	a.高耸的；高尚的
log	n.航海日志；飞行日志
longing	n.渴望
longitude	n.经线，经度
loosely	ad.松松地，松散地
loosen	vi.变松
lounge	n.(旅馆等的)休息室
lubricate	vt.使润滑vi.加润滑油
luminous	a.发光的；光明的
lump	vt.(使)成团
lunar	a.月亮的
luncheon	n.午宴，午餐，便宴
luxurious	a.爱好奢侈的，豪华的
magician	n.魔法师；变戏法的人
magistrate	n.地方行政长官
magnet	n.有吸引力的人(或物)
magnetism	n.磁；魅力；催眠术
magnify	vt.放大，扩大
magnitude	n.大小；重大；星等
maid	n.少女；处女
maiden	n.少女，未婚女子
main	n.总管道，干线
maintenance	n.扶养；坚持
majesty	n.威严，尊严；陛下
makeup	n.组织；性格；化装品
malice	n.恶意；蓄意犯罪
mammal	n.哺乳动物
manifest	vt.表明
manipulate	vt.操作；控制，手持
mansion	n.大厦，大楼；宅第
manuscript	n.手稿，底稿，原稿
maple	n.槭树，枫树
margin	n.余地；幅度；赚头
marginal	a.记在页边的；边缘的
market	vt.(在市场上)销售
Mars	n.火星；战争
marsh	n.沼泽地，湿地
marshal	n.元帅；陆军元帅
martyr	n.烈士，殉难者
marvel	n.奇迹；惊奇
masculine	a.男性的；强壮的
massacre	n.大屠杀，残杀
massive	a.粗大的；大而重的
mast	n.桅杆；杆
mature	vt.使成熟
measurement	n.(量得的)尺寸，大小
mechanics	n.力学，机械学；结构
mechanism	n.机械装置；机制
meditate	vt.沉思，冥想，反省
melancholy	n.&a.忧郁(的)，悲伤
melody	n.旋律，曲调；歌曲
membership	n.成员资格；会员人数
menace	vt.&vi.&n.(进行)威胁
mend	vt.改正，修正；改进
merchandise	n.商品，货物
merciful	a.仁慈的，宽大的
mercury	n.汞，水银；水银柱
merit	vt.值得vi.应受赏(罚)
mesh	n.网眼，筛孔，网络
mess	vt.弄脏，弄乱，搞糟
message	n.启示，要旨，教训
metallic	a.金属的
metallurgy	n.冶金学，冶金术
metropolitan	a.主要都市的n.大主教
microprocessor	n.微信息处理机
microscopic	a.显微镜的，微观的
microwave	n.微波
mighty	a.强大的；巨大的
migrate	vi.迁移，移居
mild	a.(烟、酒)味淡的
milky	a.牛奶的；乳白色的
millionaire	n.百分富翁，巨富
mingle	vt.使混合vi.混合起来
miniature	n.缩影
minimize	vt.使减到最小
mint	n.薄荷；薄荷糖
mint	n.造币厂；巨额，富源
mirror	n.反映，借鉴
mishief	n.调皮，捣蛋，胡闹
miser	n.守财奴，吝啬鬼
misery	n.痛苦，悲惨，不幸
misfortune	n.不幸，灾祸，灾难
missionary	n.传教士
mist	n.薄雾
mistress	n.情妇，情人
mitten	n.连指手套；露指手套
mixer	n.混合者，搅拌器
mob	vi.聚众闹事
mobilize	vt.动员
mock	n.嘲弄
moderately	ad.适度地，适中
modesty	n.谦逊；端庄；羞怯
modification	n.缓和；修改；修饰
modulate	vt.调整，调节(声音)
module	n.模数；模；组件
molecular	a.分子的；克分子的
momentary	a.瞬息间的，片刻的
monarch	n.君主，最高统治者
monk	n.和尚，僧侣，修道士
monopoly	n.垄断，独占，专利
monster	n.怪物；畸形的动植物
monstrous	a.可怕的；极大的
moor	vt.使停泊；使固定
mop	n.墩布，洗碗刷
morality	n.道德，美德，品行
mortgage	n.抵押
Moslem	n.&a.穆斯林(的)
moss	n.苔藓，地衣
motel	n.汽车游客旅馆
motive	a.发动的，运动的
motorway	n.汽车道，快车路
mount	v.装配；固定
mountainous	a.多山的；山一般的
move	n.行动，步骤
multiplication	n.增加；繁殖；乘法
multitude	n.大批，大群；大量
municipal	a.市的，市立的
murmur	n.低沉连续的声音
muscular	a.肌肉发达的，强健的
muse	vi.沉思，默想，冥想
mustard	n.芥子，芥末
mute	n.弱音器；闭止音
mystery	n.神秘小说，侦探小说
napkin	n.餐巾(纸)
narration	n.叙述；故事；叙述法
negative	a.负的，阴性的
negligible	a.微不足道的
negotiate	vi.谈判，交涉，议定
neighbouring	a.邻近的，接壤的
nest	vi.筑巢
net	vt.用网捕；用网覆盖
network	n.网络；广播网
neutron	n.中子
nice	a.细微的，微妙的
nickel	n.镍；镍币
nickname	n.绰号，浑号
nightmare	n.恶梦；经常的恐惧
nominate	vt.提名，推荐；任命
norm	n.标准，规范；平均数
normalization	n.正常化，标准化
northward(s)	ad.向北方
nose	n.突出部分(如船头等)
notable	n.值得注意的；著名的
noted	a.著名的，知名的
notify	vt.通知，告知；报告
notion	n.概念，意念；看法
notorious	a.臭名昭著的
notwithstanding	prep.尽管，虽然
nought	n.无，零
nourish	vt.提供养分，养育
nourishment	n.食物；营养(情况)
novel	a.新的，异常的
novelty	n.新颖；新奇的事物
nucleus	n.原子核；细胞核
number	vt.共计，达…之数
numerical	a.数字的，数值的
nun	n.修女，尼姑
nursery	n.苗圃，养鱼池
nut	n.螺帽，螺母
oar	n.桨；划手
oath	n.誓言，誓约，宣誓
obedience	n.服从，顺从；管辖
obedient	n.服从的，顺从的
objective	n.宾格
obligation	n.义务，职责，责任
oblige	vt.使感激；施恩惠于
obscure	a.阴暗的；蒙昧的
observation	n.意见，短评，按语
observe	vi.说，评述，评论
obstinate	a.固执的；顽强的
occurrence	n.事故
offence	n.犯罪，犯规；冒犯
offensive	a.冒犯的；进攻的
offer	vt.呈现出
offset	n.分支，抵销
offspring	n.儿女，子孙，后代
ohm	n.欧姆
olive	n.橄榄，橄榄树
onward(s)	a.向前(的)，在前面
opaque	a.不透明的；不传导的
operation	n.运算
opium	n.鸦片；麻醉剂
optical	a.光的；光学的
optimism	n.乐观，乐观主义
optimum	n.最适条件，最适度
option	n.选择，取舍
orchard	n.果园
orchestra	n.管弦乐队的全部乐器
ordinarily	ad.通常，大概
orient	n.东方；亚洲，远东
orientation	n.向东；定位；方向
originate	vi.发源
ornament	n.装饰物
ornamental	a.装饰的
otherwise	ad.另外；在其他方面
ought	v.aux
outbreak	n.(战争、愤怒等)爆发
outcome	n.后果，成果
outermost	a.最外面的，最远的
outlaw	n.逃犯，歹徒
outlet	n.发泄(感情等)的方法
outline	vt.概述，概括
outside	prep.在…外，向…外
oval	a.卵形的
over	prep.在(做)…时
overall	a.综合的
overestimate	vt.过高估计
overflow	vt.从…中溢出
overhang	vt.悬于…之上vi.悬垂
overhear	vt.偶然听到；偷听
overlap	vt.与…交搭
overload	vt.使超载
overlook	vt.眺望；看漏；宽容
overseas	ad.在海外，(向)国外
overtake	vt.突然袭击，压倒
overthrow	vt.推翻
overwhelm	vt.压倒，使不知所措
overwhelming	a.压倒的，势不可挡的
oxide	n.氧化物
oxidize	vt.氧化，使生锈
oyster	n.牡蛎；沉默寡言的人
pace	vi.(马)溜蹄走
pacific	a.性情温和的
pal	n.好朋友；同谋
pamphlet	n.小册子
panel	n.(选定的)专门小组
panic	n.恐慌，惊慌
pant	vi.气喘
panther	n.豹，黑豹；美洲狮
pantry	n.食品柜，餐具室
pants	n.裤子；男用短衬裤
paper	vt.用纸包装(或覆盖)
parachute	n.降落伞；风散种子
parade	vt.夸耀(才能等)
paragraph	n.小新闻，短评
paralyse	vt.使麻痹，使瘫痪
parameter	n.参(变)数；参量
participant	n.参加者
participate	vi.参与
particular	a.苛求的；特称的
partition	n.分开，分割；融墙
passport	n.达到目的的手段
pasture	n.牧场；牲畜饲养
patent	a.专利的
pathetic	a.哀婉动人的；可怜的
patriot	n.爱国者，爱国主义者
patriotic	a.爱国的
patrol	n.巡逻
patron	n.庇护人；赞助人
pattern	vt.仿制，仿造，模仿
peacock	n.孔雀
peak	n.(物体的)尖端
peck	vt.&vi.啄，啄起
peculiarity	n.特性，独特性；怪癖
pedal	n.踏脚，踏板，脚蹬
pedestrian	n.行人，步行者
pedlar	n.(挨户兜售的)小贩
peel	n.果皮，蔬菜皮
peer	vi.凝视；隐约出现
penalty	n.处罚，刑罚；罚款
penetration	n.穿入；渗透，侵入
pendulum	n.(钟等的)摆
perception	n.感觉；概念；理解力
perch	n.(禽鸟的)栖木
perfect	vt.使熟练，使改善
perfection	n.尽善尽美；无比精确
peril	n.危机；危险的事物
perimeter	n.周(边)，周长
periodic	n.周期的；一定时期的
periodical	n.期刊，杂志
peripheral	a.周界的；末梢的
perish	vi.死亡，夭折；枯萎
perpendicular	a.垂直的
perpetual	a.永久的；四季开花的
perplex	vt.迷惑，困惑，难住
persecute	vt.迫害，残害
persevere	vi.坚持，不屈不挠
persist	vi.持续，存留
persistence	n.坚持；持续，存留
personality	n.人格，个性；人物
personnel	n.人事部门
persuasion	n.劝说，说服；主张
pertinent	a.恰当的；有关的
pest	n.害虫；害人虫
petition	n.请愿
petty	a.细小的；器量小的
photoelectric	a.光电的
photography	n.摄影术
physically	ad.物质上；体格上
pickle	n.腌制食品，泡菜
pier	n.(桥)墩；码头
pierce	vt.穿透，戳穿，洞察
pilgrim	n.香客，朝圣者
pineapple	n.凤梨，波萝
pious	a.虔诚的；虔奉宗教的
pipe	n.管乐器
pirate	n.海盗；每盗船
piston	n.活塞
pitch	n.人造树脂
plague	n.瘟疫，鼠疫；天灾
plain	a.坦白的；普通的
plastic	a.塑料的；塑性的
plateau	n.高原；平稳时期
platform	n.政纲，党纲，宣言
plea	n.请愿，请求，恳求
plead	vt.为…辩护
pledge	n.誓言
pluck	vt.鼓起(勇气)，振作
plump	vt.丰满的；鼓起的
plunder	v.&n.掠夺，劫掠
pneumatic	a.空气的；气动的
poke	vt.戳，刺；伸(头等)
polar	a.南(北)极的；极性的
polarity	n.极性；(思想等)归向
politics	n.政纲，政见，策略
poll	n.投票
polymer	n.聚合物，多聚物
ponder	vt.考虑
pop	vi.(意外地)出现
pope	n.(罗马天主教的)教皇
popularity	n.通俗性；普及，流行
porcelain	n.瓷
pore	n.毛孔，气孔，细孔
portable	a.可移动的
pose	vt.(使)摆好姿势
position	n.主张，立场；形势
positive	a.正的；阳性的
positively	ad.确定的，断然
possibility	n.可能的事
postal	a.邮政的，邮局的
postulate	vt.要求，假定，假设
poultry	n.家禽
practicable	a.能实行的；适用的
prairie	n.大草原，牧场
preach	vt.说教，布道；鼓吹
precede	vt.先于…
predecessor	n.前辈，前任者
prediction	n.预言，预告；预报
predominant	a.占优势的；主要的
pregnant	a.怀孕的；意义深长的
prejudice	n.偏见，成见；损害
prescription	n.药方，处方的药
presentation	n.介绍；赠送；呈现
preservation	n.保存，储藏；保持
preset	vt.预先装置
preside	vi.主持；主奏
press	n.印刷机，印刷所
pressure	n.电压；大气压力
prestige	n.威望，威信，声望
presumably	ad.推测起来，大概
presume	vt.假定，假设，揣测
prevalent	a.流行的；盛行的
prevention	n.预防，阻止，妨碍
prey	vi.猎物
prick	vt.刺(穿)
primitive	a.远古的，未开化的
principally	ad.主要，大抵
printer	n.印刷工；印花工
priority	n.先，前；优先，重点
prism	n.棱柱(体)；棱镜
probe	n.探针
proceeding	n.程序，行动，事项
producer	n.生产者；舞台监督
productive	a.生产的；出产…的
productivity	n.生产率；多产
proficiency	n.熟练，精通
proficient	a.熟练的，精通的
profitable	a.有利的；有益的
profound	a.深刻的；渊博的
program	vi.编制程序
prohibition	n.禁止；禁令，禁律
projector	n.投影仪；探照灯
prolong	vt.延长，拉长，拖延
promotion	n.促进；提升；创立
promptly	ad.敏捷地，迅速地
propaganda	n.宣传；宣传机构
propagate	vt.繁殖；传播，普及
propagation	n.繁殖；传播；蔓延
propel	vt.推进，推动
propeller	n.螺旋桨，推进器
proper	a.合乎体统的，正派的
prophecy	n.预言，预言能力
prophet	n.预言家，先知
proposition	n.命题，主题；提议
propulsion	n.推进，推进力
prose	n.散文
proton	n.质子，氕核
prototype	n.原型；典型，范例
proverb	n.谚语，格言，箴言
province	n.领域，范围，职权
provision	n.规定，条款，条项
provoke	vt.对…挑衅；激发
prudent	a.谨慎的；精明的
psychology	n.心理学；心理
puff	vi.喘气
pulley	n.滑轮，滑车，皮带轮
pumpkin	n.南瓜，南瓜藤
punch	vt.冲压
puppy	n.小狗；幼小的动物
purify	vt.提纯，精炼(金属)
pyjamas	n.(宽大的)睡衣裤
qualification	n.资格；限制条件
qualify	vt.限制，限定，修饰
qualitative	a.质的；定性的
quantify	vt.确定…的数量
quantitative	a.量的；定量的
quarterly	a.季度的
quartz	n.石英
quench	vt.熄灭，扑灭；压制
quest	vt.寻找
question	vt.问，询问，讯问
questionable	a.可疑的，不可靠的
questionnaire	n.调查表，征求意见表
quiver	vi.(轻微地)颤动
radial	a.光线的；放射的
radiant	a.绚丽的；容光焕发的
radiator	n.暖气片，散热器
radical	a.基本的；激进的
radius	n.半径距离；界限
raise	vt.提出，发起，发出
raisin	n.葡萄干
rally	n.&vt.&vi.(重新)集合
ramble	vi.闲逛，漫步；聊天
ranch	n.(北美洲的)大牧场
random	n.随机
range	vt.排列；把…分类
rap	n.轻敲击声
rapidity	n.快，迅速；陡，险峻
rapture	n.狂喜，欢天喜地
rascal	n.流氓，恶棍，无赖
rash	a.轻率的；鲁莽的
rate	n.价格
rational	a.推理的；适度的
rattle	vt.发出格格声
reactor	n.反应器；反应堆
realistic	a.现实的；现实主义的
realization	n.(理想等的)实现
rear	vt.饲养，培植；抚养
reason	vt.辩论，讨论
rebuke	vt.指责，非难，斥责
receiver	n.接待者；收受者
recipe	n.菜谱，烹饪法；处方
reciprocal	a.相互的；互利的
reckless	a.粗心大意的；鲁莽的
reckon	vi.数，算帐
reclaim	vt.开垦，开拓；回收
recognition	n.认出，识别；重视
recommendation	n.推荐，介绍；建议
reconcile	vt.使和好；调停
recreation	n.消遣，娱乐活动
rectangle	n.矩形，长方形
rectify	vt.纠正；调整；精馏
reed	n.芦笛，牧笛
reef	n.礁，礁石，暗礁
reel	vt.卷，绕
referee	n.(足球等)裁判员
reference	n.参考文献；参照系
refinery	n.精炼厂，提炼厂
refrain	vi.抑制，制止，忍住
refreshment	n.(精力的)恢复，爽快
refugee	n.难民，流亡者
regenerative	a.新生的；回授的
regime	n.政体，政权；制度
regiment	n.团，军团；一大群
regularity	n.规则性；整齐
regulate	vt.调整，调节，对准
regulation	n.规章，规则；调节
reign	n.朝代
reject	vt.舍弃，抛弃；排斥
relay	vt.分程传递；使接替
religion	n.信念，信条
remainder	n.剩余(物)；余数
repay	vt.&vi.偿还，报答
repeal	vt.撤销；放弃
repel	vt.拒绝；使厌恶
replace	vt.送还，归还，赔还
replacement	n.归还；取代；置换
report	n.传说，议论
representation	n.描写；陈述；代表
representative	a.代表性的；代议制的
reproduce	vt.仿造
reproduction	n.再生(产)；繁殖
reptile	n.爬行动物；两栖动物
requisite	a.需要的
resemblance	n.相似，相似性
resent	vt.对…不满，怨恨
reservation	n.保留；预定，预订
reserve	n.缄默，自我克制
reside	vi.居住，驻扎；属于
resident	n.常住者
residual	a.剩余的；残数的
resign	vt.使顺从，使听任于
resignation	n.听从，屈从，顺从
resolute	a.坚决的，果敢的
respectable	a.可敬的；人格高尚的
response	n.回音，回签；灵敏度
responsible	a.重要的；可靠的
restrain	vt.抑制，制止，遏制
resultant	a.作为结果而发生的
resume	n.(谋职者的)个人简历
retail	n.零售
retard	vt.延迟，放慢
retirement	n.退休，引退；退隐
retort	vt.&vi.反击；反驳
reveal	vt.告诉，揭示，泄露
revenue	n.收入；收入数目
reverse	n.背面，反面
revive	vt.&vi.苏醒；复兴
revolve	vt.&vi.(使)旋转
ridicule	vi.&n.嘲弄，挖苦
rigorous	a.(性格等)严峻的
rim	n.边；边缘，(眼镜)框
rinse	vt.涮，嗽；冲洗
riot	n.&vi.骚乱，暴乱
rip	vi.撕啐，扯破，划破
ripple	n.涟漪，细浪，波纹
roam	vt.在…漫步，漫游
roller	n.滚柱，滚筒，辊
Roman	n.罗马人，古罗马人
romance	n.传奇；浪漫文学
romantic	a.好幻想的
rooster	n.公鸡；狂妄自负的人
rotate	vt.&vi.(使)旋转
roundabout	a.迂回的；转弯抹角的
routine	a.日常的
row	n.吵嚷，吵架，口角
royalty	n.皇家，王族，皇族
ruby	n.红宝石
rule	n.裁决，裁定
ruthless	a.无情的，冷酷的
safeguard	n.保护措施；护照
salmon	n.鲑，大马哈鱼
salute	vt.迎接，欢迎
sandwich	vt.夹入，挤进
sardine	n.沙丁鱼
satellite	n.附属物
satisfaction	n.快事，乐事；愉快
satisfactorily	ad.圆满地
saturation	n.饱和(状态)；浸透
Saturn	n.农神；土星
scan	n.扫描，扫掠
scandal	n.丑事，丑闻；耻辱
scar	n.瘢痕
scarcity	n.缺乏，不足，萧条
scarlet	n.猩红色
scheme	vt.计划
scholarship	n.学问，学识；奖学金
scoff	vt.&vi.嘲笑，嘲弄
scope	n.眼界
scorch	vi.烧焦，枯萎；挖苦
scout	vt.搜索，侦察，跟踪
scramble	vi.&n.爬行，攀登
scrap	n.碎片；废料
scratch	n.起跑线，起步线
scripture	n.《圣经》；圣书
scrub	n.&vt.擦洗，擦净
sculpture	n.雕刻(术)；雕刻品
seam	n.缝口；接缝；骨缝
seaport	n.海港，港口，港市
seaside	n.海滨(胜地)；海边
second	vt.支持
second-hand	n.旧的，第二手的
section	n.切下的部分
seemingly	ad.表面上，外表上
segment	n.切片，部分；段，节
selection	n.精选的东西；选择
senator	n.参议员；评议员
sensation	n.感觉，知觉；轰动
senseless	a.愚蠢的，无意义的
sensible	a.明显的，感觉得到的
sensitivity	n.敏感(性)；灵敏性
sensor	n.传感器，灵敏元件
sentiment	n.感情；情操；情绪
sequence	n.序列
sermon	n.布道，讲道，说教
serpent	n.蛇(尤指大蛇或毒蛇)
set	n.集(合)
settlement	n.调停；(新)住宅区
severe	a.激烈的；简朴的
shabby	a.褴褛的；破旧的
shade	n.(色彩的)浓淡，深浅
shadowy	a.有影的；幽暗的
shady	a.可疑的，靠不住的
shaft	n.(工具的)柄，杆状物
sham	n.假冒；膺品
shame	vt.使羞愧，玷辱
shameful	a.可耻的；不道德的
shark	n.鲨鱼；贪婪狡猾的人
sharply	ad.严厉地，苛刻地
shatter	vt.粉碎，破碎；毁坏
sheer	a.纯粹的；全然的
shell	n.炮弹，猎枪子弹
sheriff	n.郡长；警察局长
shipbuilding	n.造船(业)，造船学
shipment	n.装货；装载的货物
shipwreck	n.船舶失事
shortage	n.短缺，不足额
shortcut	n.近路，捷径
shorten	vt.弄短，缩小，减少
shorthand	n.速记，速记法
should	v.aux.应该，竟然会
shoulder	vt.承担，挑起，肩负
shove	vt.推
shovel	n.铲，铁铲
shower	vi.下阵雨
shrill	a.尖声的
shrimp	n.(小)虾，河虾，褐虾
shrine	n.神殿，神龛，圣祠
shrub	n.灌木，灌木丛
shrug	vt.&vi.耸(肩)
shutter	n.百叶窗；(相机)快门
shuttle	n.(织机的)梭
sideways	ad.斜向一边地
siege	n.包围，围攻，围困
sift	vt.筛，过滤
sight	n.情景，名胜，风景
sign	n.征兆，迹象，病症
significant	a.有效的
signify	vt.表示，意味着
silicon	n.硅(旧名矽)
similarity	n.类似，相似；类似点
simple	a.单纯的；迟钝的
simplicity	n.单纯，质朴
simultaneous	a.同时的，同时存在的
sincerity	n.真诚，诚意；真实
singular	a.异常的，奇异的
sink	n.(厨房内的)洗涤槽
siren	n.汽笛，警报器
sitting-room	n.起居室
situated	a.位于…的
situation	n.(建筑物等的)位置
skeleton	n.骨骼，骷髅；骨架
skip	vi.跳；跳绳；略过
skyscraper	n.摩天楼
slack	a.萧条的；懈怠的
slander	n.&vt.诽谤，诋毁
slang	n.俚语；行话，黑话
slap	vt.掴，拍
slaughter	vt.&n.屠杀，屠宰
slave	vi.作苦工
slide	n.滑板，滑座
slim	a.细长的；微小的
slit	vt.切开
slumber	n.睡眠；沉睡状态
smart	vi.刺疼，扎疼，剧痛
smash	vt.打碎，打破，粉碎
smuggle	vt.私运
snack	n.快餐，小吃
snail	n.蜗牛；行动缓慢的人
snap	vt.猛咬，突然折断
sneer	vi.&n.冷笑；嘲笑
sneeze	vi.打喷嚏
sniff	vi.用鼻子吸
snob	n.势利小人
snobbish	a.势利的，谄上欺下的
snore	vi.打鼾，打呼噜
sociology	n.社会学
sodium	n.钠
sofa	n.长沙发，沙发
soften	vt.使软化
softness	n.温和，柔和；软弱
software	n.(计算机的)软件
solar	a.利用太阳光的
solidarity	n.团结；休戚相关
solidify	vt.&vi.团结；凝固
solo	n.独唱，独奏；独唱曲
sophisticated	a.老于世故的；高级的
sorrowful	a.使人伤心的；悲伤的
southwards	ad.向南方
sovereign	n.君主
souvenir	n.纪念品，黄豆
soy	n.酱油；大豆，黄豆
spacious	a.广阔的，广大的
span	n.(桥墩间的)墩距
spatial	a.空间的，占据空间的
specialize	vt.使专门化，专业化
species	n.种，物种；种类
specification	n.载明，详述；规格
specimen	n.抽样，样品
spectacle	n.场面；景象，奇观
spectator	n.参观者，观众
spectrum	n.系列，范围；波谱
speculate	vi.思索，沉思；投机
spherical	a.球形的，球面的
spice	n.香料，调味品；香气
spill	n.(人)摔下，跌下
spiral	a.螺旋(形)的，盘旋的
spite	n.恶意，怨恨
splash	vt.溅泼
split	n.分裂，分化；派系
spokesman	n.发言人，代言人
squash	vt.压碎
squat	vi.&vt.(使)蹲下
squeeze	n.压榨；榨取，佣金
stability	n.坚定
stagger	vi.蹒跚
stainless	a.纯洁的；不锈的
stairway	n.楼梯
stalk	n.主茎，叶柄；高烟囱
stall	n.货摊，书摊；厩
stammer	vt.口吃地说
standardize	vt.使与标准比较
start	vt.开动，着手；开设
stationery	n.文具；信笺
statistics	n.统计，统计数字
steady	a.坚定的，扎实的
steak	n.大块牛肉；牛排
steal	vt.偷偷地做，巧取
stem	n.词干；(手表的)转柄
stereo	n.立体声
stern	n.艉，船尾；臀部
stew	vt.炖
stiff	a.生硬的
stiffness	n.硬度
stillness	n.寂静，无声
sting	n.剧痛；刺激
stitch	n.一针，缝线
stone	n.果核，(水果的)硬核
storage	n.贮藏，保管；仓库
storm	n.爆发
stout	a.矮胖的；坚固的
straighten	vt.把…弄直vi.挺起来
straightforward	a.老实的
strait	n.海峡
strange	a.外地的，异乡的
stray	vi.迷路
streamline	n.流线；流线型
strength	n.兵力；强度
stride	vi.大踏步走
strife	n.冲突，竞争
striking	a.显著的，惊人的
strip	n.窄条，长带
strive	vi.努力，奋斗，力求
stroll	n.散步，溜达，闲逛
stubborn	a.顽固的；顽强的
studio	n.工作室；播音室
stuffy	a.不透气的，闷热的
sturdy	a.坚定的；牢固的
subdivide	vt.把…再分
subdue	vt.使屈服，征服
subject	vt.使隶属
subordinate	a.下级的，辅助的
subscribe	vi.订购，认购；预订
subscript	a.写在下方的
subscription	n.预约，用户，订阅费
subsequent	a.尔后的
subsequently	ad.其后，其次，接着
subsidiary	a.辅助的，补充的
substance	n.财产；内容，本旨
substantial	a.物质的；坚固的
subtle	a.微妙的；精巧的
succession	n.继承(权)，后裔
successor	n.继承人，继任者
suffice	vi.足够；有能力
suicide	n.&vi.&vt.自杀
suit	vt.使配合vi.彼此协调
suitcase	n.小提箱，衣箱
sullen	a.绷着脸不高兴的
summary	a.概括的；速决的
summit	n.顶点，最高点；极度
summon	vt.召唤；鼓起(勇气)
superb	a.壮丽的；超等的
superficial	a.表面的；肤浅的
superiority	n.优越(性)，优势
supersonic	a.超声的，超声速的
superstition	n.迷信，迷信行为
supervise	vt.&vi.监督，监视
supplement	n.补角
support	vt.经受，承受，忍受
suppress	vt.镇压；抑制；隐瞒
surpass	vt.超过，超越，胜过
surplus	n.过剩，剩余(物资)
survival	n.幸存，残存；幸存者
suspicious	a.可疑的；猜疑的
sweeten	vt.使变甜
sweetness	n.甜蜜；新鲜；温和
swell	vi.&vt.使膨胀，隆起
switch	n.(树木的)软枝条
symmetrical	a.对称的，匀称的
symmetry	n.对称(性)，匀称
symphony	n.交响乐；交响乐团
symposium	n.酒会；座谈会
symptom	n.症状，征候，征兆
synthesis	n.合成；综合，综合物
systematic	a.成体系的；分类的
systematically	ad.系统地，有规则地
tabulate	vt.把…制成表
tack	n.平头打
tackle	vt.解决，对付
tact	n.机敏，圆滑，得体
tactics	n.策略；战术，兵法
tangle	vt.使缠结，使纠缠
tanker	n.油船；空中加油飞机
tape	vt.系，捆
taper	n.细小的蜡烛；微光
tar	n.柏油，焦油
team	vi.协作，合作
tease	vt.逗乐，戏弄；强求
telex	n.电传，用户电报
tempt	vt.引诱，诱惑，劝诱
tensile	a.张力的；能伸长的
terminal	n.计算机终端；线接头
terminate	vt.&vi.停止，终止
terminology	n.术语学，术语
terrace	n.平台，阳台，露台
terrify	vt.使恐怖，使惊吓
terrorist	n.恐怖分子
testify	v.证明，证实，作证
Thanksgiving	n.感恩节
theatre	n.戏剧效果
theft	n.盗窃，偷窃(行为)
theme	n.题目；词干；主旋律
theorem	n.定理；原理，原则
theory	n.见解，看法，推测
thereafter	ad.此后，以后
therein	ad.在那里，在那时
thereof	ad.它的，其；由此
thermal	a.热的；温泉的
thesis	n.论题，论点；论文
thicken	vt.使变厚(或粗、密)
thigh	n.股，大腿
thorough	a.精心的；详尽的
thoughtless	a.欠考虑的；自私的
thrash	vt.痛打，鞭打
thresh	vt.打谷，脱粒；推敲
threshold	n.门槛；入门，开端
thrifty	a.节俭的；兴旺的
thrill	vt.&vi.(使)激动
through	prep.因为，由于
ticket	n.(交通违章)罚款传票
tickle	vt.挠，胳肢；逗乐
tighten	vt.&vi.(使)变紧
tightly	ad.紧地，牢固地
tile	n.瓦片，瓷砖；贴砖
tilt	vt.&vi.(使)倾斜
timely	a.及时的；适时的
tiresome	a.使人厌倦的，讨厌的
toad	n.蟾蜍，癞蛤蟆
token	n.象征；辅币；纪念品
tolerant	a.容忍的；有耐力的
tone	n.色调，光度；风气
torment	n.痛苦
torpedo	n.鱼雷，水雷
torque	n.转(力)矩，扭(力)矩
toss	vi.翻来复去
tow	vt.&n.拖引，牵引
towards	prep.为了，有助于
tower	vi.高耸，屹立；翱翔
track	vi.留下足迹
trade	vi.做买卖；交换
trader	n.商人；商船
tradesman	n.商人；手艺人
tragic	a.悲剧性的，悲惨的
tramp	vt.&vi.&n.步行，跋涉
trample	vt.&vi.&n.践踏，蹂躏
tranquil	a.平静的；稳定的
transaction	n.处理；交易；和解
transform	vt.变压；变换
transition	n.转变，变迁；过渡
transmission	n.遗传，传染
transplant	vt.&vi.移植，移种
transverse	a.横切的
traverse	vt.横越，横切，横断
tread	vi.&vt.踩，踏，践踏
treasurer	n.司库，财务主管
trench	n.深沟；壕沟，战壕
triangular	a.三角的；三者间的
tribute	n.贡物；献礼，贡献
trifle	vi.玩忽；闲混；嬉耍
trigger	n.扳机
triumphant	a.得胜的；得意洋洋的
trivial	a.琐碎的；平常的
trolley	n.手推车；无轨电车
troop	n.一群，一队，大量
tropic	n.热带地区；回归线
tropical	a.热带的；炎热的
trot	vi.&n.(马)小跑，慢跑
troublesome	a.累赘的，困难的
tuberculosis	n.结核病，肺结核
tug	vi.用力拖
tulip	n.郁金香
tuna	n.金枪鱼
turtle	n.海龟，玳瑁；甲鱼肉
tutor	vt.教，指导
twilight	n.黎明，黄昏；曙光
twist	v.歪曲，曲解
tyranny	n.暴政，专制；残暴
tyrant	n.暴君；专制君主
ultimate	a.基本的，首要的
ultrasonic	a.超声的
ultraviolet	a.紫外的n.紫外线辐射
unanimous	a.(全体)一致的
uncertain	a.不定的；无常的
underestimate	vt.低估，看轻
underline	vt.着重；预告
undertake	vt.约定，保证；从事
undertaking	n.任务，事业；承担
underwear	n.衫衣，内衣，贴身衣
undesirable	a.不合需要的；讨厌的
uneasy	a.不安的；拘束的
unemployment	n.失业；失业人数
unfit	a.不合适的；无能力的
unfold	vt.展开
uniformly	ad.相同地；一贯
unique	a.无可匹敌的；极好的
universally	ad.普遍地，一般地
unlimited	a.无限的；不定的
unlock	vt.开…的锁；开启
unpaid	a.未付的；不支薪水的
unreasonable	a.不讲道理的；过度的
untie	vt.解开，松开；解放
uphold	vt.举起；支撑；赞成
uproar	n.骚动，扰乱；喧嚣
uranium	n.铀
urge	vt.&vi.强烈希望
usage	n.习惯法
utensil	n.器皿，用具
utilization	n.利用，效用
vaccinate	vt.给…种牛痘
validity	n.有效，效力；正确
valuable	n.贵重物品，财宝
value	vt.尊重，重视，评价
valve	n.阀，阀门；电子管
vault	n.拱顶；地下室，地窖
vector	n.矢量；飞机航线
veil	vt.以面纱遮掩vi.遮盖
vein	n.静脉，血管，矿脉
velocity	n.迅速，快速
velvet	a.丝绒制的；柔软的
vengeance	n.报复，报仇，复仇
ventilate	vt.使通风，使换气
Venus	n.维纳斯；美人；色情
verge	n.边缘，边界，界限
versatile	a.多方面的；通用的
verse	n.诗，韵文；诗行
version	n.解释
versus	prep.(比赛等中)对
veto	n.否决，否决权，禁止
vicinity	n.邻近；附近地区
vicious	a.邪恶的；恶性的
video	a.录象的
vigorous	a.精力旺盛的，茁壮的
vigour	n.活力，精力；元气
villa	n.别墅；城郊小屋
vine	n.蔓，藤，藤本植物
violate	vt.违犯，违背；侵犯
violation	n.违犯；侵犯，妨碍
violent	a.狂暴的；歪曲的
virgin	n.处女
virtual	a.实际上的，实质上的
visa	n.签证
viscous	a.粘滞的，粘性的
vision	n.视力；眼光，想象力
visit	vt.常去
vital	a.生命的，生机的
vitamin	n.维生素，维他命
vocabulary	n.词汇表，词汇汇编
vocation	n.职业，行业
void	a.空的；无效的
volunteer	n.志愿者
vow	n.誓言，誓约，许愿
vowel	n.元音；元音字母
vulgar	a.粗俗的，庸俗的
wade	vt.趟(河)，跋涉
wag	vt.摇，摇摆，摆动
waggon	n.敞蓬车厢
waitress	n.女侍者，女服务员
walnut	n.胡桃，核桃树
ward	n.病房，病室；监房
wardrobe	n.衣柜，衣橱，藏衣室
ware	n.商品，货物；物品
warehouse	n.仓库，货栈
warfare	n.战争，战争状态
warning	n.警告，告诫，鉴诫
warrant	n.许可证，委任状
wasp	n.黄蜂，蚂蜂
wasteful	a.浪费的；破坏性的
watchful	a.注意的，警惕的
watertight	a.不漏水的，防水的
watery	a.水的；湿的；乏味的
watt	n.瓦(特)
waver	vi.摇摆；犹豫不决
way	n.状态，状况，规模
weaver	n.织布工，编织者
web	n.网，丝，网状物
wedge	n.楔
whale	n.鲸；庞然大物
wharf	n.码头，停泊所
what	a.所…的，尽可能多的
whereby	ad.靠什么；靠那个
whilst	conj.同…同时；然而
whisper	vt.低声地讲，私下说
white	a.白种(人)的
whitewash	n.石灰水
whoever	pron.究竟是谁
wholesome	a.适合卫生的
widely	ad.大大地
wield	vt.挥(剑)；行使
willow	n.柳树，柳木
wind	n.胸口，心窝
winding	n.卷绕着的线a.卷曲的
windmill	n.风车
windy	a.多风的，刮风的
wink	vi.眨眼；使眼色
wisdom	n.(古人的)名言，格言
wither	vi.枯萎
whereas	conj.而，却，反之
witty	a.机智的；风趣的
woe	n.悲哀，悲痛，苦恼
woodpecker	n.啄木鸟
workpiece	n.工(作)件
workshop	n.专题讨论会
worship	vt.崇拜
wrath	n.暴怒，狂怒，愤慨
wrench	vt.拧，扭伤
wrestle	n.摔交；斗争，搏斗
wretched	a.不幸的；卑鄙的
wring	vt.拧，挤，扭，榨
wrinkle	n.皱纹
xerox	vt.&vi.用静电复印
yacht	n.游艇，快艇
yearn	vi.想念，怀念，向往
yeast	n.酵母
yoke	n.轭，牛轭；枷锁
yolk	n.蛋黄，卵黄
youngster	n.儿童，少年，年轻人
zinc	n.锌
